//MAP CONVERTED BY dmm2tgm.py THIS HEADER COMMENT PREVENTS RECONVERSION, DO NOT REMOVE
"aa" = (
/turf/template_noop,
/area/template_noop)
"ab" = (
/turf/closed/wall,
/area/crew_quarters/theatre)
"ac" = (
/obj/structure/piano{
	icon_state = "piano"
	},
/turf/open/floor/carpet,
/area/crew_quarters/theatre)
"ad" = (
/obj/structure/chair/stool{
	pixel_y = 8
	},
/turf/open/floor/carpet,
/area/crew_quarters/theatre)
"ae" = (
/turf/open/floor/carpet,
/area/crew_quarters/theatre)
"af" = (
/obj/machinery/atmospherics/components/unary/vent_pump/on/layer1{
	dir = 4
	},
/turf/open/floor/carpet,
/area/crew_quarters/theatre)
"ag" = (
/obj/structure/window/reinforced{
	dir = 4
	},
/obj/machinery/atmospherics/pipe/simple/supply/hidden/layer1{
	dir = 8
	},
/turf/open/floor/carpet,
/area/crew_quarters/theatre)
"ah" = (
/obj/machinery/atmospherics/pipe/simple/supply/hidden/layer1{
	dir = 8
	},
/turf/open/floor/wood,
/area/crew_quarters/bar)
"ai" = (
/obj/structure/chair/stool,
/obj/machinery/atmospherics/pipe/simple/scrubbers/hidden,
/obj/machinery/atmospherics/pipe/manifold/supply/hidden/layer1{
	dir = 4
	},
/turf/open/floor/wood,
/area/crew_quarters/bar)
"aj" = (
/obj/machinery/computer/slot_machine,
/turf/open/floor/wood,
/area/crew_quarters/bar)
"ak" = (
/turf/closed/wall,
/area/crew_quarters/bar)
"al" = (
/obj/machinery/airalarm{
	dir = 4;
	pixel_x = -22
	},
/obj/machinery/light/small{
	dir = 8
	},
/obj/structure/reagent_dispensers/beerkeg,
/turf/open/floor/wood,
/area/crew_quarters/bar)
"am" = (
/obj/structure/disposalpipe/segment,
/obj/effect/landmark/xeno_spawn,
/obj/machinery/atmospherics/pipe/simple/supply/hidden/layer1{
	dir = 1
	},
/turf/open/floor/wood,
/area/crew_quarters/bar)
"an" = (
/obj/machinery/vending/wardrobe/bar_wardrobe,
/turf/open/floor/wood,
/area/crew_quarters/bar)
"ao" = (
/obj/machinery/vending/cola/random,
/turf/open/floor/wood,
/area/crew_quarters/bar)
"ap" = (
/obj/machinery/vending/coffee,
/turf/open/floor/wood,
/area/crew_quarters/bar)
"aq" = (
/turf/closed/wall,
/area/crew_quarters/kitchen)
"ar" = (
/obj/machinery/icecream_vat,
/turf/open/floor/plasteel/showroomfloor,
/area/crew_quarters/kitchen)
"as" = (
/obj/structure/disposalpipe/segment,
/obj/machinery/atmospherics/pipe/simple/supply/hidden/layer1{
	dir = 1
	},
/obj/machinery/atmospherics/pipe/simple/scrubbers/hidden,
/turf/open/floor/plasteel/showroomfloor,
/area/crew_quarters/kitchen)
"at" = (
/obj/machinery/chem_master/condimaster{
	name = "CondiMaster Neo"
	},
/turf/open/floor/plasteel/showroomfloor,
/area/crew_quarters/kitchen)
"au" = (
/obj/effect/turf_decal/loading_area,
/turf/open/floor/plasteel/showroomfloor,
/area/crew_quarters/kitchen)
"av" = (
/obj/structure/table/wood,
/obj/item/instrument/guitar{
	pixel_x = -7
	},
/obj/item/instrument/eguitar{
	pixel_x = 5
	},
/turf/open/floor/carpet,
/area/crew_quarters/theatre)
"aw" = (
/obj/machinery/atmospherics/components/unary/vent_scrubber/on{
	dir = 4
	},
/turf/open/floor/carpet,
/area/crew_quarters/theatre)
"ax" = (
/obj/machinery/atmospherics/pipe/simple/scrubbers/hidden{
	dir = 4
	},
/obj/effect/landmark/event_spawn,
/turf/open/floor/carpet,
/area/crew_quarters/theatre)
"ay" = (
/obj/machinery/atmospherics/pipe/simple/scrubbers/hidden{
	dir = 4
	},
/turf/open/floor/carpet,
/area/crew_quarters/theatre)
"az" = (
/obj/machinery/door/window{
	dir = 4;
	name = "Theatre Stage"
	},
/obj/machinery/atmospherics/pipe/simple/scrubbers/hidden{
	dir = 4
	},
/turf/open/floor/carpet,
/area/crew_quarters/theatre)
"aA" = (
/obj/machinery/atmospherics/pipe/simple/scrubbers/hidden{
	dir = 4
	},
/turf/open/floor/wood,
/area/crew_quarters/bar)
"aB" = (
/obj/structure/chair/stool,
/obj/machinery/atmospherics/pipe/manifold/scrubbers/hidden{
	dir = 4
	},
/obj/machinery/atmospherics/pipe/simple/supply/hidden/layer1{
	dir = 1
	},
/turf/open/floor/wood,
/area/crew_quarters/bar)
"aC" = (
/obj/machinery/computer/slot_machine,
/obj/machinery/light/small{
	dir = 4
	},
/obj/machinery/status_display/evac{
	pixel_x = 32
	},
/turf/open/floor/wood,
/area/crew_quarters/bar)
"aD" = (
/obj/structure/closet/secure_closet/bar{
	req_access_txt = "25"
	},
/turf/open/floor/wood,
/area/crew_quarters/bar)
"aE" = (
/obj/structure/disposalpipe/segment,
/obj/machinery/atmospherics/components/unary/vent_pump/on/layer1{
	dir = 1
	},
/turf/open/floor/wood,
/area/crew_quarters/bar)
"aF" = (
/obj/item/reagent_containers/food/drinks/shaker,
/obj/structure/table/wood,
/obj/item/stack/spacecash/c10,
/obj/item/stack/spacecash/c100,
/turf/open/floor/wood,
/area/crew_quarters/bar)
"aG" = (
/obj/structure/kitchenspike,
/obj/machinery/light/small{
	dir = 8
	},
/turf/open/floor/plasteel/showroomfloor,
/area/crew_quarters/kitchen)
"aH" = (
/obj/machinery/atmospherics/pipe/manifold/scrubbers/hidden{
	icon_state = "manifold-2";
	dir = 1
	},
/mob/living/simple_animal/hostile/retaliate/goat{
	name = "Pete"
	},
/turf/open/floor/plasteel/showroomfloor,
/area/crew_quarters/kitchen)
"aI" = (
/obj/machinery/atmospherics/components/unary/vent_scrubber/on{
	dir = 8
	},
/turf/open/floor/plasteel/showroomfloor,
/area/crew_quarters/kitchen)
"aJ" = (
/obj/machinery/light/small{
	dir = 4
	},
/obj/machinery/airalarm{
	dir = 8;
	pixel_x = 24
	},
/obj/machinery/vending/wardrobe/chef_wardrobe,
/turf/open/floor/plasteel/showroomfloor,
/area/crew_quarters/kitchen)
"aK" = (
/obj/structure/window/reinforced,
/obj/structure/table/wood,
/obj/item/instrument/violin,
/obj/item/saxophone,
/turf/open/floor/carpet,
/area/crew_quarters/theatre)
"aL" = (
/obj/structure/window/reinforced,
/turf/open/floor/carpet,
/area/crew_quarters/theatre)
"aM" = (
/obj/structure/window/reinforced,
/obj/structure/window/reinforced{
	dir = 4
	},
/turf/open/floor/carpet,
/area/crew_quarters/theatre)
"aN" = (
/turf/open/floor/wood,
/area/crew_quarters/bar)
"aO" = (
/obj/machinery/atmospherics/pipe/simple/scrubbers/hidden,
/obj/structure/chair/stool,
/obj/machinery/atmospherics/pipe/simple/supply/hidden/layer1{
	dir = 1
	},
/turf/open/floor/wood,
/area/crew_quarters/bar)
"aP" = (
/obj/machinery/door/airlock{
	name = "Bar Storage";
	req_access_txt = "25"
	},
/obj/structure/disposalpipe/segment,
/turf/open/floor/plasteel{
	icon_state = "wood"
	},
/area/crew_quarters/bar)
"aQ" = (
/obj/effect/landmark/blobstart,
/obj/item/toy/beach_ball/holoball,
/turf/open/floor/plating,
/area/crew_quarters/bar)
"aR" = (
/obj/structure/kitchenspike,
/turf/open/floor/plasteel/showroomfloor,
/area/crew_quarters/kitchen)
"aS" = (
/obj/structure/disposalpipe/segment,
/obj/machinery/atmospherics/pipe/manifold/supply/hidden/layer1{
	dir = 8
	},
/turf/open/floor/plasteel/showroomfloor,
/area/crew_quarters/kitchen)
"aT" = (
/obj/machinery/atmospherics/pipe/simple/scrubbers/hidden,
/obj/machinery/atmospherics/components/unary/vent_pump/on/layer1{
	dir = 8
	},
/turf/open/floor/plasteel/showroomfloor,
/area/crew_quarters/kitchen)
"aU" = (
/turf/open/floor/plasteel/showroomfloor,
/area/crew_quarters/kitchen)
"aV" = (
/obj/machinery/gibber,
/turf/open/floor/plasteel/showroomfloor,
/area/crew_quarters/kitchen)
"aW" = (
/obj/structure/table,
/obj/machinery/computer/security/telescreen/entertainment{
	pixel_x = -31
	},
/obj/item/clothing/head/hardhat/cakehat,
/turf/open/floor/wood,
/area/crew_quarters/bar)
"aX" = (
/obj/structure/chair/stool,
/turf/open/floor/wood,
/area/crew_quarters/bar)
"aY" = (
/obj/machinery/atmospherics/pipe/simple/scrubbers/hidden,
/obj/machinery/atmospherics/pipe/simple/supply/hidden/layer1{
	dir = 1
	},
/turf/open/floor/wood,
/area/crew_quarters/bar)
"aZ" = (
/obj/effect/spawner/structure/window,
/turf/open/floor/wood,
/area/crew_quarters/bar)
"ba" = (
/obj/structure/sign/warning/securearea{
	desc = "Under the painting a plaque reads: 'While the meat grinder may not have spared you, fear not. Not one part of you has gone to waste... You were delicious.'";
	icon_state = "monkey_painting";
	name = "Mr. Deempisi portrait";
	pixel_x = -28;
	pixel_y = -4
	},
/obj/machinery/button/door{
	id = "barShutters";
	name = "bar shutters";
	pixel_x = 4;
	pixel_y = 28
	},
/obj/machinery/disposal/bin,
/obj/structure/disposalpipe/trunk{
	dir = 4
	},
/turf/open/floor/wood,
/area/crew_quarters/bar)
"bb" = (
/obj/structure/disposalpipe/segment{
	dir = 9
	},
/turf/open/floor/wood,
/area/crew_quarters/bar)
"bc" = (
/obj/machinery/firealarm{
	dir = 8;
	pixel_x = 24
	},
/obj/item/radio/intercom{
	pixel_y = 25
	},
/obj/structure/table/reinforced,
/obj/machinery/chem_dispenser/drinks/beer{
	dir = 8
	},
/turf/open/floor/wood,
/area/crew_quarters/bar)
"bd" = (
/obj/machinery/door/airlock{
	name = "Kitchen cold room";
	req_access_txt = "28"
	},
/obj/structure/disposalpipe/segment,
/obj/machinery/atmospherics/pipe/simple/supply/hidden/layer1{
	dir = 1
	},
/turf/open/floor/plasteel/showroomfloor,
/area/crew_quarters/kitchen)
"be" = (
/obj/machinery/atmospherics/pipe/simple/scrubbers/hidden,
/turf/closed/wall,
/area/crew_quarters/kitchen)
"bf" = (
/obj/effect/landmark/event_spawn,
/turf/closed/wall,
/area/crew_quarters/bar)
"bg" = (
/obj/machinery/light{
	dir = 8
	},
/obj/structure/chair/stool,
/turf/open/floor/wood,
/area/crew_quarters/bar)
"bh" = (
/obj/structure/chair,
/obj/effect/landmark/start/assistant,
/turf/open/floor/wood,
/area/crew_quarters/bar)
"bi" = (
/obj/structure/chair/stool/bar,
/turf/open/floor/wood,
/area/crew_quarters/bar)
"bj" = (
/obj/structure/table/reinforced,
/obj/item/lighter,
/obj/machinery/camera{
	c_tag = "Bar";
	network = list("SS13")
	},
/turf/open/floor/wood,
/area/crew_quarters/bar)
"bk" = (
/obj/machinery/light{
	dir = 4
	},
/turf/open/floor/wood,
/area/crew_quarters/bar)
"bl" = (
/obj/machinery/vending/boozeomat,
/turf/open/floor/wood,
/area/crew_quarters/bar)
"bm" = (
/obj/machinery/vending/dinnerware,
/turf/open/floor/plasteel/cafeteria,
/area/crew_quarters/kitchen)
"bn" = (
/obj/structure/sink/kitchen{
	pixel_y = 28
	},
/obj/machinery/food_cart,
/turf/open/floor/plasteel/cafeteria,
/area/crew_quarters/kitchen)
"bo" = (
/obj/structure/extinguisher_cabinet{
	pixel_x = -5;
	pixel_y = 30
	},
/obj/machinery/grill,
/turf/open/floor/plasteel/cafeteria,
/area/crew_quarters/kitchen)
"bp" = (
/obj/structure/disposalpipe/segment,
/obj/machinery/atmospherics/pipe/simple/supply/hidden/layer1{
	dir = 1
	},
/turf/open/floor/plasteel/cafeteria,
/area/crew_quarters/kitchen)
"bq" = (
/obj/item/radio/intercom{
	pixel_y = 25
	},
/obj/machinery/camera{
	c_tag = "Kitchen"
	},
/obj/structure/closet/secure_closet/freezer/fridge,
/obj/machinery/atmospherics/pipe/simple/scrubbers/hidden,
/turf/open/floor/plasteel/cafeteria,
/area/crew_quarters/kitchen)
"br" = (
/obj/structure/table,
/obj/machinery/microwave{
	pixel_x = -3;
	pixel_y = 6
	},
/obj/machinery/airalarm{
	pixel_y = 24
	},
/obj/machinery/light{
	dir = 1
	},
/turf/open/floor/plasteel/cafeteria,
/area/crew_quarters/kitchen)
"bs" = (
/obj/structure/table,
/obj/machinery/microwave{
	pixel_x = -3;
	pixel_y = 6
	},
/turf/open/floor/plasteel/cafeteria,
/area/crew_quarters/kitchen)
"bt" = (
/obj/structure/closet/secure_closet/freezer/kitchen,
/turf/open/floor/plasteel/cafeteria,
/area/crew_quarters/kitchen)
"bu" = (
/obj/effect/spawner/structure/window,
/obj/machinery/door/poddoor/preopen{
	id = "barShutters";
	name = "privacy shutters"
	},
/turf/open/floor/plating,
/area/crew_quarters/bar)
"bv" = (
/obj/structure/chair{
	dir = 4
	},
/turf/open/floor/wood,
/area/crew_quarters/bar)
"bw" = (
/obj/structure/table,
/obj/item/kitchen/fork,
/turf/open/floor/wood,
/area/crew_quarters/bar)
"bx" = (
/obj/structure/chair{
	dir = 8
	},
/turf/open/floor/wood,
/area/crew_quarters/bar)
"by" = (
/obj/machinery/atmospherics/components/unary/vent_pump/on/layer1{
	dir = 4
	},
/turf/open/floor/wood,
/area/crew_quarters/bar)
"bz" = (
/obj/structure/chair/stool,
/obj/machinery/atmospherics/pipe/simple/supply/hidden/layer1{
	dir = 8
	},
/turf/open/floor/wood,
/area/crew_quarters/bar)
"bA" = (
/obj/structure/table/wood/poker,
/obj/item/toy/cards/deck,
/obj/machinery/atmospherics/pipe/simple/supply/hidden/layer1{
	dir = 8
	},
/turf/open/floor/wood,
/area/crew_quarters/bar)
"bB" = (
/obj/machinery/atmospherics/pipe/simple/scrubbers/hidden,
/obj/machinery/atmospherics/pipe/simple/supply/hidden/layer1{
	dir = 9
	},
/turf/open/floor/wood,
/area/crew_quarters/bar)
"bC" = (
/obj/structure/table/reinforced,
/obj/item/reagent_containers/food/drinks/shaker,
/turf/open/floor/wood,
/area/crew_quarters/bar)
"bD" = (
/mob/living/carbon/monkey/punpun,
/turf/open/floor/wood,
/area/crew_quarters/bar)
"bE" = (
/obj/structure/table/reinforced,
/obj/machinery/chem_dispenser/drinks{
	dir = 8
	},
/obj/machinery/requests_console{
	department = "Bar";
	departmentType = 2;
	pixel_x = 30;
	receive_ore_updates = 1
	},
/turf/open/floor/wood,
/area/crew_quarters/bar)
"bF" = (
/turf/open/floor/plasteel/cafeteria,
/area/crew_quarters/kitchen)
"bG" = (
/obj/machinery/atmospherics/components/unary/vent_pump/on/layer1{
	dir = 4
	},
/turf/open/floor/plasteel/cafeteria,
/area/crew_quarters/kitchen)
"bH" = (
/obj/effect/landmark/start/cook,
/obj/machinery/atmospherics/pipe/simple/supply/hidden/layer1{
	dir = 8
	},
/turf/open/floor/plasteel/cafeteria,
/area/crew_quarters/kitchen)
"bI" = (
/obj/structure/disposalpipe/segment{
	dir = 5
	},
/obj/machinery/atmospherics/pipe/simple/supply/hidden/layer1{
	dir = 9
	},
/turf/open/floor/plasteel/cafeteria,
/area/crew_quarters/kitchen)
"bJ" = (
/obj/structure/disposalpipe/segment{
	dir = 4
	},
/obj/machinery/atmospherics/pipe/simple/scrubbers/hidden{
	dir = 5
	},
/turf/open/floor/plasteel/cafeteria,
/area/crew_quarters/kitchen)
"bK" = (
/obj/structure/disposalpipe/segment{
	dir = 4
	},
/obj/machinery/atmospherics/pipe/simple/scrubbers/hidden{
	dir = 4
	},
/turf/open/floor/plasteel/cafeteria,
/area/crew_quarters/kitchen)
"bL" = (
/obj/structure/disposalpipe/segment{
	dir = 10
	},
/obj/machinery/atmospherics/components/unary/vent_scrubber/on{
	dir = 8
	},
/turf/open/floor/plasteel/cafeteria,
/area/crew_quarters/kitchen)
"bM" = (
/obj/machinery/airalarm{
	dir = 4;
	pixel_x = -22
	},
/obj/machinery/camera{
	c_tag = "Bar West";
	dir = 4
	},
/turf/open/floor/wood,
/area/crew_quarters/bar)
"bN" = (
/obj/structure/chair{
	dir = 1
	},
/turf/open/floor/wood,
/area/crew_quarters/bar)
"bO" = (
/obj/effect/landmark/event_spawn,
/obj/effect/spawner/xmastree,
/turf/open/floor/wood,
/area/crew_quarters/bar)
"bP" = (
/obj/machinery/atmospherics/pipe/simple/scrubbers/hidden,
/turf/open/floor/wood,
/area/crew_quarters/bar)
"bQ" = (
/obj/structure/table/reinforced,
/obj/item/clothing/head/that,
/turf/open/floor/wood,
/area/crew_quarters/bar)
"bR" = (
/obj/effect/landmark/start/bartender,
/turf/open/floor/wood,
/area/crew_quarters/bar)
"bS" = (
/obj/machinery/door/firedoor,
/obj/machinery/door/airlock/public/glass{
	name = "Kitchen";
	req_access_txt = "28"
	},
/turf/open/floor/plasteel/cafeteria,
/area/crew_quarters/kitchen)
"bT" = (
/obj/structure/table,
/obj/item/reagent_containers/food/snacks/mint,
/turf/open/floor/plasteel/cafeteria,
/area/crew_quarters/kitchen)
"bU" = (
/obj/structure/table,
/obj/item/reagent_containers/food/condiment/saltshaker{
	pixel_x = -3
	},
/obj/item/reagent_containers/food/condiment/peppermill{
	pixel_x = 3
	},
/turf/open/floor/plasteel/cafeteria,
/area/crew_quarters/kitchen)
"bV" = (
/obj/structure/table,
/obj/item/kitchen/rollingpin,
/turf/open/floor/plasteel/cafeteria,
/area/crew_quarters/kitchen)
"bW" = (
/obj/structure/table,
/obj/item/book/manual/chef_recipes,
/turf/open/floor/plasteel/cafeteria,
/area/crew_quarters/kitchen)
"bX" = (
/obj/structure/disposalpipe/segment,
/turf/open/floor/plasteel/cafeteria,
/area/crew_quarters/kitchen)
"bY" = (
/obj/machinery/holopad,
/turf/open/floor/wood,
/area/crew_quarters/bar)
"bZ" = (
/obj/structure/chair,
/turf/open/floor/wood,
/area/crew_quarters/bar)
"ca" = (
/obj/structure/table/reinforced,
/turf/open/floor/wood,
/area/crew_quarters/bar)
"cb" = (
/obj/machinery/door/poddoor/preopen{
	id = "barShutters";
	name = "privacy shutters"
	},
/obj/effect/spawner/structure/window,
/turf/open/floor/plating,
/area/crew_quarters/kitchen)
"cc" = (
/obj/structure/table,
/obj/item/reagent_containers/food/condiment/enzyme{
	layer = 5
	},
/obj/item/stack/packageWrap,
/turf/open/floor/plasteel/cafeteria,
/area/crew_quarters/kitchen)
"cd" = (
/obj/structure/table,
/obj/item/storage/box/donkpockets{
	pixel_x = 3;
	pixel_y = 3
	},
/obj/item/reagent_containers/glass/beaker{
	pixel_x = 5
	},
/turf/open/floor/plasteel/cafeteria,
/area/crew_quarters/kitchen)
"ce" = (
/obj/machinery/deepfryer,
/turf/open/floor/plasteel/cafeteria,
/area/crew_quarters/kitchen)
"cf" = (
/obj/machinery/processor,
/obj/machinery/firealarm{
	dir = 8;
	pixel_x = 24
	},
/turf/open/floor/plasteel/cafeteria,
/area/crew_quarters/kitchen)
"cg" = (
/obj/machinery/light{
	dir = 8
	},
/obj/machinery/computer/security/telescreen/entertainment{
	pixel_x = -31
	},
/turf/open/floor/wood,
/area/crew_quarters/bar)
"ch" = (
/obj/structure/table/wood/poker,
/obj/item/clothing/mask/cigarette/cigar,
/obj/item/toy/cards/deck,
/turf/open/floor/wood,
/area/crew_quarters/bar)
"ci" = (
/obj/structure/table,
/obj/item/reagent_containers/food/condiment/peppermill{
	pixel_x = 5;
	pixel_y = -2
	},
/obj/item/reagent_containers/food/condiment/saltshaker{
	pixel_x = -2;
	pixel_y = 2
	},
/turf/open/floor/wood,
/area/crew_quarters/bar)
"cj" = (
/obj/structure/table/reinforced,
/obj/item/stack/spacecash/c100,
/obj/item/stack/spacecash/c100,
/obj/item/stack/spacecash/c100,
/turf/open/floor/wood,
/area/crew_quarters/bar)
"ck" = (
/obj/structure/table/reinforced,
/obj/item/reagent_containers/glass/rag,
/turf/open/floor/wood,
/area/crew_quarters/bar)
"cl" = (
/obj/machinery/door/window/southright{
	name = "Bar Door";
	req_one_access_txt = "25;28"
	},
/turf/open/floor/wood,
/area/crew_quarters/bar)
"cm" = (
/obj/structure/table/reinforced,
/obj/machinery/computer/security/telescreen/entertainment{
	pixel_x = 32
	},
/obj/item/book/manual/wiki/barman_recipes,
/turf/open/floor/wood,
/area/crew_quarters/bar)
"cn" = (
/obj/effect/landmark/start/cook,
/turf/open/floor/plasteel/cafeteria,
/area/crew_quarters/kitchen)
"co" = (
/obj/structure/table,
/obj/machinery/reagentgrinder,
/obj/machinery/requests_console{
	department = "Kitchen";
	departmentType = 2;
	pixel_x = 30
	},
/turf/open/floor/plasteel/cafeteria,
/area/crew_quarters/kitchen)
"cp" = (
/obj/structure/chair{
	dir = 1
	},
/obj/effect/landmark/start/assistant,
/turf/open/floor/wood,
/area/crew_quarters/bar)
"cq" = (
/obj/machinery/atmospherics/components/unary/vent_scrubber/on{
	dir = 1
	},
/turf/open/floor/wood,
/area/crew_quarters/bar)
"cr" = (
/obj/structure/chair/stool/bar,
/obj/effect/landmark/start/assistant,
/turf/open/floor/wood,
/area/crew_quarters/bar)
"cs" = (
/obj/structure/chair/stool/bar,
/obj/effect/landmark/event_spawn,
/turf/open/floor/wood,
/area/crew_quarters/bar)
"ct" = (
/obj/machinery/door/firedoor,
/obj/machinery/door/airlock{
	name = "Kitchen";
	req_access_txt = "28"
	},
/turf/open/floor/wood,
/area/crew_quarters/kitchen)
"cu" = (
/obj/machinery/light_switch{
	pixel_y = -25
	},
/turf/open/floor/plasteel/cafeteria,
/area/crew_quarters/kitchen)
"cv" = (
/obj/machinery/light,
/turf/open/floor/plasteel/cafeteria,
/area/crew_quarters/kitchen)
"cw" = (
/obj/effect/landmark/event_spawn,
/turf/open/floor/plasteel/cafeteria,
/area/crew_quarters/kitchen)
"cx" = (
/obj/structure/disposalpipe/segment{
	dir = 5
	},
/obj/machinery/button/door{
	id = "kitchen";
	name = "Kitchen Shutters Control";
	pixel_x = -1;
	pixel_y = -24;
	req_access_txt = "28"
	},
/turf/open/floor/plasteel/cafeteria,
/area/crew_quarters/kitchen)
"cy" = (
/obj/machinery/disposal/bin,
/obj/structure/disposalpipe/trunk{
	dir = 8
	},
/turf/open/floor/plasteel/cafeteria,
/area/crew_quarters/kitchen)
"cz" = (
/obj/machinery/computer/arcade,
/turf/open/floor/wood,
/area/crew_quarters/bar)
"cA" = (
/obj/machinery/vending/cigarette,
/turf/open/floor/wood,
/area/crew_quarters/bar)
"cB" = (
/obj/machinery/newscaster{
	pixel_y = -28
	},
/turf/open/floor/wood,
/area/crew_quarters/bar)
"cC" = (
/obj/machinery/light,
/obj/machinery/firealarm{
	dir = 1;
	pixel_y = -24
	},
/turf/open/floor/wood,
/area/crew_quarters/bar)
"cD" = (
/obj/machinery/light,
/turf/open/floor/wood,
/area/crew_quarters/bar)
"cE" = (
/obj/machinery/camera{
	c_tag = "Bar South";
	dir = 1
	},
/turf/open/floor/wood,
/area/crew_quarters/bar)
"cF" = (
/obj/structure/noticeboard{
	pixel_y = -27
	},
/turf/open/floor/wood,
/area/crew_quarters/bar)
"cG" = (
/obj/structure/extinguisher_cabinet{
	pixel_y = -30
	},
/turf/open/floor/wood,
/area/crew_quarters/bar)
"cH" = (
/obj/machinery/airalarm{
	dir = 1;
	pixel_y = -22
	},
/turf/open/floor/wood,
/area/crew_quarters/bar)
"cI" = (
/obj/machinery/light/small,
/turf/open/floor/wood,
/area/crew_quarters/bar)
"cJ" = (
/obj/structure/closet/crate/bin,
/turf/open/floor/wood,
/area/crew_quarters/bar)
"cK" = (
/obj/structure/table/reinforced,
/obj/item/storage/fancy/donut_box,
/obj/machinery/door/firedoor,
/obj/machinery/door/poddoor/shutters/preopen{
	id = "kitchen";
	name = "kitchen shutters"
	},
/turf/open/floor/plasteel/cafeteria,
/area/crew_quarters/kitchen)
"cL" = (
/obj/structure/table/reinforced,
/obj/machinery/door/firedoor,
/obj/machinery/door/poddoor/shutters/preopen{
	id = "kitchen";
	name = "kitchen shutters"
	},
/turf/open/floor/plasteel/cafeteria,
/area/crew_quarters/kitchen)
"cM" = (
/obj/structure/table/reinforced,
/obj/machinery/door/firedoor,
/obj/machinery/door/poddoor/shutters/preopen{
	id = "kitchen";
	name = "kitchen shutters"
	},
/obj/item/reagent_containers/food/snacks/pie/cream,
/turf/open/floor/plasteel/cafeteria,
/area/crew_quarters/kitchen)
"cN" = (
/obj/machinery/door/firedoor,
/obj/machinery/door/airlock/public/glass{
	name = "Diner"
	},
/turf/open/floor/wood,
/area/crew_quarters/bar)
"cO" = (
/obj/structure/sign/barsign,
/turf/closed/wall,
/area/crew_quarters/bar)
"cP" = (
/obj/machinery/airalarm,
/turf/closed/wall,
/area/crew_quarters/theatre)
"cQ" = (
/obj/machinery/door/airlock{
	name = "Theatre Backstage";
	req_access_txt = "46"
	},
/obj/effect/turf_decal/tile/red,
/obj/effect/turf_decal/tile/blue{
	dir = 8
	},
/turf/open/floor/plasteel,
/area/crew_quarters/theatre)
"cR" = (
/mob,
/turf/closed/wall,
/area/crew_quarters/theatre)
"cS" = (
/obj/machinery/door/airlock/maintenance{
	name = "Bar Maintenance";
	req_access_txt = "12"
	},
/obj/structure/disposalpipe/segment,
/obj/machinery/atmospherics/pipe/simple/supply/hidden/layer1,
/obj/machinery/atmospherics/pipe/simple/scrubbers/hidden,
/turf/open/floor/plating,
/area/maintenance/starboard/fore)
"cT" = (
/obj/item/stack/sheet/metal/fifty,
/obj/item/stack/sheet/glass/fifty,
/obj/item/stack/cable_coil,
/obj/item/flashlight/lamp,
/obj/item/flashlight/lamp/green,
/obj/structure/closet/secure_closet/bartender,
/turf/open/floor/wood,
/area/crew_quarters/bar)
"cU" = (
/obj/structure/disposalpipe/segment,
/obj/machinery/atmospherics/pipe/simple/supply/hidden/layer1{
	dir = 1
	},
/obj/machinery/atmospherics/pipe/simple/scrubbers/hidden,
/turf/open/floor/wood,
/area/crew_quarters/bar)
"cV" = (
/obj/structure/sink/kitchen{
	pixel_y = 28
	},
/turf/open/floor/wood,
/area/crew_quarters/bar)
"cW" = (
/obj/machinery/door/window/southleft{
	name = "Bar Delivery";
	req_access_txt = "25"
	},
/obj/effect/turf_decal/delivery,
/turf/open/floor/plasteel,
/area/crew_quarters/bar)
"cX" = (
/obj/machinery/door/airlock/maintenance{
	name = "Kitchen Maintenance";
	req_access_txt = "28"
	},
/obj/structure/disposalpipe/segment,
/obj/machinery/atmospherics/pipe/simple/supply/hidden/layer1{
	dir = 1
	},
/obj/machinery/atmospherics/pipe/simple/scrubbers/hidden,
/turf/open/floor/plating,
/area/maintenance/starboard/fore)
"cY" = (
/obj/machinery/navbeacon{
	codes_txt = "delivery;dir=2";
	freq = 1400;
	location = "Kitchen"
	},
/obj/structure/plasticflaps{
	opacity = 1
	},
/obj/effect/turf_decal/bot,
/turf/open/floor/plasteel,
/area/crew_quarters/kitchen)
"cZ" = (
/obj/machinery/light_switch{
	pixel_y = 28
	},
/obj/machinery/light{
	dir = 1
	},
/turf/open/floor/carpet,
/area/crew_quarters/theatre)
"da" = (
/obj/item/radio/intercom{
	pixel_y = 25
	},
/obj/machinery/camera{
	c_tag = "Theatre Stage"
	},
/turf/open/floor/carpet,
/area/crew_quarters/theatre)
"db" = (
/obj/structure/window/reinforced{
	dir = 4
	},
/turf/open/floor/carpet,
/area/crew_quarters/theatre)
"dc" = (
/obj/structure/disposalpipe/segment{
	dir = 5
	},
/obj/machinery/atmospherics/pipe/simple/supply/hidden/layer1,
/obj/machinery/atmospherics/pipe/simple/scrubbers/hidden,
/turf/open/floor/wood,
/area/crew_quarters/bar)
"dd" = (
/obj/machinery/disposal/bin,
/obj/structure/disposalpipe/trunk{
	dir = 8
	},
/obj/machinery/firealarm{
	pixel_y = 24
	},
/turf/open/floor/wood,
/area/crew_quarters/bar)
"de" = (
/obj/machinery/reagentgrinder,
/obj/structure/table/wood,
/turf/open/floor/wood,
/area/crew_quarters/bar)
"df" = (
/obj/structure/disposalpipe/segment,
/obj/machinery/atmospherics/pipe/simple/supply/hidden/layer1{
	dir = 1
	},
/obj/machinery/atmospherics/pipe/simple/scrubbers/hidden{
	dir = 5
	},
/turf/open/floor/wood,
/area/crew_quarters/bar)
"dg" = (
/obj/machinery/atmospherics/components/unary/vent_scrubber/on{
	dir = 8
	},
/turf/open/floor/wood,
/area/crew_quarters/bar)
"dh" = (
/obj/machinery/camera{
	c_tag = "Bar Storage"
	},
/turf/open/floor/wood,
/area/crew_quarters/bar)
"di" = (
/obj/structure/closet/secure_closet/freezer/meat,
/turf/open/floor/plasteel/showroomfloor,
/area/crew_quarters/kitchen)
"dj" = (
/obj/machinery/camera{
	c_tag = "Kitchen Cold Room"
	},
/obj/structure/reagent_dispensers/cooking_oil,
/turf/open/floor/plasteel/showroomfloor,
/area/crew_quarters/kitchen)
"dk" = (
/obj/machinery/door/window/southleft{
	name = "Kitchen Delivery";
	req_access_txt = "28"
	},
/obj/effect/turf_decal/delivery,
/obj/structure/window/reinforced{
	dir = 8
	},
/turf/open/floor/plasteel,
/area/crew_quarters/kitchen)
"KM" = (
/obj/structure/disposalpipe/segment,
/obj/machinery/atmospherics/pipe/simple/supply/hidden/layer1{
	dir = 1
	},
/obj/machinery/atmospherics/pipe/simple/scrubbers/hidden{
	dir = 5
	},
/turf/open/floor/plasteel/showroomfloor,
/area/crew_quarters/kitchen)

(1,1,1) = {"
aa
aa
ab
ab
ab
ak
bf
bu
ak
bu
ak
bu
ak
ak
"}
(2,1,1) = {"
aa
aa
ac
av
aK
aW
bg
aN
bM
aN
cg
aN
cz
ak
"}
(3,1,1) = {"
aa
aa
ad
ae
aL
aX
aN
bv
aN
aN
aX
aN
cA
ak
"}
(4,1,1) = {"
ab
cZ
ae
ae
aL
aN
bh
bw
bN
aX
ch
aX
cB
ak
"}
(5,1,1) = {"
cP
ae
ae
aw
aL
aN
aN
bx
aN
aN
aX
aN
cC
ak
"}
(6,1,1) = {"
cQ
ae
ae
ax
aL
aN
aN
by
bO
bY
aN
aN
aN
cN
"}
(7,1,1) = {"
cR
da
af
ay
aL
aN
aN
bz
aN
aN
bv
aN
aN
bu
"}
(8,1,1) = {"
ab
db
ag
az
aM
aN
aX
bA
aX
bZ
ci
cp
aN
cN
"}
(9,1,1) = {"
ak
aN
ah
aA
aN
aN
aN
bz
aN
aN
bx
aN
cD
cO
"}
(10,1,1) = {"
cS
dc
ai
aB
aO
aY
aY
bB
bP
bP
bP
cq
cE
ak
"}
(11,1,1) = {"
ak
dd
aj
aC
aj
aZ
bi
bi
bi
bi
bi
aN
cF
ak
"}
(12,1,1) = {"
ak
ak
ak
ak
ak
ak
bj
bC
bQ
ca
cj
cr
cG
ak
"}
(13,1,1) = {"
aF
de
al
aD
ak
ba
aN
aN
bR
aN
ck
cs
cH
ak
"}
(14,1,1) = {"
cU
df
am
aE
aP
bb
bk
bD
aN
aN
cl
aN
cI
ak
"}
(15,1,1) = {"
cV
dg
an
cT
ak
bc
bl
bE
aN
aN
cm
aN
cJ
ak
"}
(16,1,1) = {"
ak
dh
ao
ak
ak
aq
aq
aq
bS
cb
aq
ct
aq
aq
"}
(17,1,1) = {"
cW
aN
ap
ak
aQ
aq
bm
bF
bF
bF
bF
cu
aq
aa
"}
(18,1,1) = {"
aq
aq
aq
aq
aq
aq
bn
bG
bF
bF
bF
cv
aq
aa
"}
(19,1,1) = {"
aq
di
ar
aG
aR
aq
bo
bH
bT
cc
bF
bF
cK
aa
"}
(20,1,1) = {"
cX
as
as
KM
aS
bd
bp
bI
bU
cd
cn
bF
cL
aa
"}
(21,1,1) = {"
aq
dj
at
aH
aT
be
bq
bJ
bV
ce
bF
cw
cL
aa
"}
(22,1,1) = {"
cY
dk
au
aI
aU
aq
br
bK
bW
ce
bF
bF
cM
aa
"}
(23,1,1) = {"
aq
aq
aq
aJ
aV
aq
bs
bL
bX
bX
bX
cx
aq
aa
"}
(24,1,1) = {"
aa
aa
aq
aq
aq
aq
bt
bF
bF
cf
co
cy
aq
aa
"}
