//MAP CONVERTED BY dmm2tgm.py THIS HEADER COMMENT PREVENTS RECONVERSION, DO NOT REMOVE
"a" = (
/turf/closed/wall,
/area/maintenance/aft)
"b" = (
/obj/effect/decal/cleanable/cobweb,
/turf/open/floor/wood{
	icon_state = "wood-broken5"
	},
/area/maintenance/aft)
"e" = (
/turf/open/floor/wood,
/area/maintenance/aft)
"g" = (
/obj/structure/table/wood,
/obj/item/paper_bin,
/obj/item/pen/blue,
/obj/item/pen/red,
/obj/item/pen,
/turf/open/floor/wood,
/area/maintenance/aft)
"h" = (
/obj/structure/bookcase/random/fiction,
/turf/open/floor/wood,
/area/maintenance/aft)
"i" = (
/obj/structure/closet/crate/freezer,
/obj/item/reagent_containers/food/drinks/soda_cans/dr_gibb,
/obj/item/reagent_containers/food/drinks/soda_cans/lemon_lime,
/obj/item/reagent_containers/food/drinks/soda_cans/sodawater,
/obj/item/reagent_containers/food/drinks/beer,
/turf/open/floor/wood,
/area/maintenance/aft)
"k" = (
/obj/machinery/door/airlock/maintenance,
/obj/effect/mapping_helpers/airlock/abandoned,
/turf/open/floor/wood,
/area/maintenance/aft)
"l" = (
/turf/open/floor/wood{
	icon_state = "wood-broken6"
	},
/area/maintenance/aft)
"m" = (
/obj/structure/chair/wood,
/turf/open/floor/wood,
/area/maintenance/aft)
"n" = (
/obj/structure/table/wood,
/turf/open/floor/wood{
	icon_state = "wood-broken6"
	},
/area/maintenance/aft)
"G" = (
/obj/structure/closet/crate/necropolis,
/obj/item/clothing/head/helmet/gladiator,
/obj/item/clothing/under/gladiator,
/turf/open/floor/wood,
/area/maintenance/aft)

(1,1,1) = {"
a
b
e
n
"}
(2,1,1) = {"
a
g
m
n
"}
(3,1,1) = {"
a
e
e
g
"}
(4,1,1) = {"
a
i
l
e
"}
(5,1,1) = {"
a
h
e
G
"}
(6,1,1) = {"
a
a
k
a
"}
