//MAP CONVERTED BY dmm2tgm.py THIS HEADER COMMENT PREVENTS RECONVERSION, DO NOT REMOVE
"a" = (
/turf/closed/wall/r_wall,
/area/science/research)
"b" = (
/obj/structure/cable,
/obj/structure/disposalpipe/segment{
	dir = 4
	},
/obj/machinery/door/airlock/research{
	name = "Break Room";
	req_access_txt = "47"
	},
/obj/machinery/door/firedoor/heavy,
/turf/open/floor/plasteel/white,
/area/science/research)
"c" = (
/obj/structure/cable,
/obj/machinery/light_switch{
	pixel_x = 8;
	pixel_y = 28
	},
/obj/structure/disposalpipe/junction{
	dir = 4
	},
/turf/open/floor/plasteel,
/area/science/research)
"d" = (
/obj/structure/cable,
/obj/machinery/firealarm{
	pixel_y = 24
	},
/obj/structure/disposalpipe/segment{
	dir = 4
	},
/turf/open/floor/plasteel,
/area/science/research)
"e" = (
/obj/structure/table/wood,
/obj/machinery/microwave{
	desc = "Cooks and boils stuff, somehow.";
	pixel_x = -3;
	pixel_y = 5
	},
/obj/structure/extinguisher_cabinet{
	pixel_x = 0;
	pixel_y = 28
	},
/obj/effect/turf_decal/tile/neutral{
	dir = 1
	},
/obj/effect/turf_decal/tile/neutral{
	dir = 4
	},
/obj/effect/turf_decal/tile/neutral{
	dir = 8
	},
/obj/structure/disposalpipe/segment{
	dir = 4
	},
/obj/structure/cable,
/turf/open/floor/plasteel,
/area/science/research)
"f" = (
/obj/structure/table/wood,
/obj/item/storage/box/donkpockets,
/obj/effect/turf_decal/tile/neutral{
	dir = 1
	},
/obj/effect/turf_decal/tile/neutral{
	dir = 4
	},
/obj/structure/disposalpipe/segment{
	dir = 4
	},
/obj/structure/cable,
/obj/machinery/airalarm{
	pixel_y = 23
	},
/turf/open/floor/plasteel,
/area/science/research)
"g" = (
/obj/effect/turf_decal/tile/neutral{
	dir = 1
	},
/obj/effect/turf_decal/tile/neutral{
	dir = 4
	},
/obj/structure/disposalpipe/segment{
	dir = 4
	},
/obj/structure/cable,
/obj/structure/closet/wardrobe/science_white,
/turf/open/floor/plasteel,
/area/science/research)
"h" = (
/obj/effect/turf_decal/tile/neutral{
	dir = 1
	},
/obj/effect/turf_decal/tile/neutral{
	dir = 4
	},
/obj/structure/disposalpipe/segment{
	dir = 4
	},
/obj/structure/cable,
/obj/item/kirbyplants/random,
/obj/item/radio/intercom{
	dir = 8;
	pixel_x = 0;
	pixel_y = 22
	},
/turf/open/floor/plasteel,
/area/science/research)
"i" = (
/obj/effect/turf_decal/tile/neutral{
	dir = 1
	},
/obj/effect/turf_decal/tile/neutral,
/obj/effect/turf_decal/tile/neutral{
	dir = 4
	},
/obj/structure/disposalpipe/segment{
	dir = 4
	},
/obj/structure/cable,
/turf/open/floor/plasteel,
/area/science/research)
"j" = (
/obj/machinery/door/firedoor/heavy,
/obj/machinery/atmospherics/pipe/simple/scrubbers/hidden{
	dir = 4
	},
/obj/effect/spawner/structure/window,
/obj/machinery/atmospherics/pipe/simple/supply/hidden/layer1{
	dir = 8
	},
/turf/open/floor/plating,
/area/science/research)
"k" = (
/obj/machinery/atmospherics/pipe/simple/scrubbers/hidden{
	dir = 4
	},
/obj/structure/disposalpipe/segment,
/obj/machinery/atmospherics/pipe/simple/supply/hidden/layer1{
	dir = 8
	},
/turf/open/floor/plasteel,
/area/science/research)
"l" = (
/obj/effect/turf_decal/tile/red{
	dir = 1
	},
/obj/effect/turf_decal/tile/red,
/obj/effect/turf_decal/tile/yellow{
	dir = 4
	},
/obj/effect/turf_decal/tile/yellow{
	dir = 8
	},
/obj/machinery/atmospherics/pipe/manifold/supply/hidden/layer1{
	dir = 1
	},
/obj/machinery/atmospherics/pipe/simple/scrubbers/hidden{
	dir = 4
	},
/turf/open/floor/plasteel,
/area/science/research)
"m" = (
/obj/effect/turf_decal/tile/red{
	dir = 1
	},
/obj/effect/turf_decal/tile/red,
/obj/effect/turf_decal/tile/yellow{
	dir = 4
	},
/obj/effect/turf_decal/tile/yellow{
	dir = 8
	},
/obj/machinery/atmospherics/pipe/simple/scrubbers/hidden{
	dir = 4
	},
/obj/machinery/atmospherics/pipe/simple/supply/hidden/layer1{
	dir = 8
	},
/turf/open/floor/plasteel,
/area/science/research)
"n" = (
/obj/effect/turf_decal/tile/red{
	dir = 1
	},
/obj/effect/turf_decal/tile/red,
/obj/effect/turf_decal/tile/yellow{
	dir = 4
	},
/obj/effect/turf_decal/tile/yellow{
	dir = 8
	},
/obj/machinery/atmospherics/pipe/simple/scrubbers/hidden{
	dir = 4
	},
/obj/machinery/atmospherics/pipe/manifold/supply/hidden/layer1{
	dir = 1
	},
/turf/open/floor/plasteel,
/area/science/research)
"o" = (
/obj/effect/turf_decal/tile/red{
	dir = 1
	},
/obj/effect/turf_decal/tile/red,
/obj/effect/turf_decal/tile/yellow{
	dir = 4
	},
/obj/effect/turf_decal/tile/yellow{
	dir = 8
	},
/obj/machinery/atmospherics/pipe/simple/supply/hidden/layer1{
	dir = 8
	},
/obj/machinery/atmospherics/pipe/manifold/scrubbers/hidden{
	dir = 1
	},
/turf/open/floor/plasteel,
/area/science/research)
"p" = (
/obj/structure/cable,
/obj/machinery/power/apc{
	areastring = "/area/science/research";
	dir = 4;
	name = "Break Room APC";
	pixel_x = 26
	},
/obj/machinery/atmospherics/pipe/simple/supply/hidden/layer1{
	dir = 8
	},
/obj/machinery/atmospherics/pipe/simple/scrubbers/hidden{
	dir = 4
	},
/turf/open/floor/plasteel,
/area/science/research)
"q" = (
/obj/machinery/atmospherics/pipe/simple/scrubbers/hidden{
	dir = 4
	},
/obj/machinery/atmospherics/pipe/simple/supply/hidden/layer1{
	dir = 8
	},
/turf/closed/wall/r_wall,
/area/science/research)
"r" = (
/turf/closed/wall,
/area/science/research)
"s" = (
/obj/effect/turf_decal/tile/neutral{
	dir = 1
	},
/obj/effect/turf_decal/tile/neutral,
/obj/effect/turf_decal/tile/neutral{
	dir = 4
	},
/obj/effect/turf_decal/tile/neutral{
	dir = 8
	},
/obj/machinery/disposal/bin,
/obj/structure/disposalpipe/trunk{
	dir = 1
	},
/obj/effect/turf_decal/bot,
/turf/open/floor/plasteel,
/area/science/research)
"t" = (
/obj/effect/turf_decal/tile/red{
	dir = 1
	},
/obj/effect/turf_decal/tile/red,
/obj/effect/turf_decal/tile/yellow{
	dir = 4
	},
/obj/effect/turf_decal/tile/yellow{
	dir = 8
	},
/obj/machinery/atmospherics/pipe/simple/supply/hidden/layer1,
/turf/open/floor/plasteel,
/area/science/research)
"u" = (
/obj/effect/turf_decal/tile/red{
	dir = 1
	},
/obj/effect/turf_decal/tile/red,
/obj/effect/turf_decal/tile/yellow{
	dir = 4
	},
/obj/effect/turf_decal/tile/yellow{
	dir = 8
	},
/obj/effect/landmark/event_spawn,
/turf/open/floor/plasteel,
/area/science/research)
"v" = (
/obj/effect/turf_decal/tile/red{
	dir = 1
	},
/obj/effect/turf_decal/tile/red,
/obj/effect/turf_decal/tile/yellow{
	dir = 4
	},
/obj/effect/turf_decal/tile/yellow{
	dir = 8
	},
/turf/open/floor/plasteel,
/area/science/research)
"w" = (
/obj/effect/turf_decal/tile/red{
	dir = 1
	},
/obj/effect/turf_decal/tile/red,
/obj/effect/turf_decal/tile/yellow{
	dir = 4
	},
/obj/effect/turf_decal/tile/yellow{
	dir = 8
	},
/obj/machinery/atmospherics/pipe/simple/scrubbers/hidden,
/turf/open/floor/plasteel,
/area/science/research)
"x" = (
/obj/effect/turf_decal/tile/neutral,
/obj/effect/turf_decal/tile/neutral{
	dir = 4
	},
/obj/machinery/vending/cigarette,
/turf/open/floor/plasteel,
/area/science/research)
"y" = (
/obj/structure/table/wood,
/obj/item/reagent_containers/food/drinks/soda_cans/dr_gibb,
/obj/effect/turf_decal/tile/neutral,
/obj/effect/turf_decal/tile/neutral{
	dir = 4
	},
/obj/machinery/light{
	dir = 8
	},
/turf/open/floor/plasteel,
/area/science/research)
"z" = (
/obj/effect/turf_decal/tile/red{
	dir = 1
	},
/obj/effect/turf_decal/tile/red,
/obj/effect/turf_decal/tile/yellow{
	dir = 4
	},
/obj/effect/turf_decal/tile/yellow{
	dir = 8
	},
/obj/machinery/atmospherics/components/unary/vent_pump/on/layer1{
	dir = 1
	},
/obj/structure/chair/stool,
/obj/effect/landmark/start/scientist,
/turf/open/floor/plasteel,
/area/science/research)
"A" = (
/obj/effect/turf_decal/tile/red{
	dir = 1
	},
/obj/effect/turf_decal/tile/red,
/obj/effect/turf_decal/tile/yellow{
	dir = 4
	},
/obj/effect/turf_decal/tile/yellow{
	dir = 8
	},
/obj/machinery/atmospherics/components/unary/vent_scrubber/on{
	dir = 1
	},
/turf/open/floor/plasteel,
/area/science/research)
"B" = (
/obj/machinery/camera{
	c_tag = "Science - Break Room";
	dir = 8;
	name = "science camera";
	network = list("ss13","rd")
	},
/obj/effect/turf_decal/tile/neutral,
/obj/effect/turf_decal/tile/neutral{
	dir = 4
	},
/obj/machinery/vending/cola/random,
/obj/machinery/light{
	dir = 4
	},
/turf/open/floor/plasteel,
/area/science/research)
"C" = (
/obj/structure/table/wood,
/obj/machinery/newscaster{
	pixel_x = -32
	},
/obj/item/clipboard,
/obj/item/folder,
/obj/effect/turf_decal/tile/neutral,
/obj/effect/turf_decal/tile/neutral{
	dir = 4
	},
/turf/open/floor/plasteel,
/area/science/research)
"D" = (
/obj/effect/turf_decal/tile/red{
	dir = 1
	},
/obj/effect/turf_decal/tile/red,
/obj/effect/turf_decal/tile/yellow{
	dir = 4
	},
/obj/effect/turf_decal/tile/yellow{
	dir = 8
	},
/obj/structure/chair/stool,
/turf/open/floor/plasteel,
/area/science/research)
"E" = (
/obj/structure/cable,
/obj/machinery/door/airlock/maintenance{
	name = "Break Room Maintenance";
	req_access_txt = "47"
	},
/obj/structure/disposalpipe/segment{
	dir = 4
	},
/turf/open/floor/plating,
/area/maintenance/starboard)
"F" = (
/obj/effect/decal/cleanable/dirt,
/obj/effect/turf_decal/tile/red{
	dir = 1
	},
/obj/effect/turf_decal/tile/red,
/obj/effect/turf_decal/tile/yellow{
	dir = 4
	},
/obj/effect/turf_decal/tile/yellow{
	dir = 8
	},
/turf/open/floor/plasteel,
/area/science/research)
"G" = (
/obj/effect/turf_decal/tile/neutral,
/obj/effect/turf_decal/tile/neutral{
	dir = 4
	},
/obj/machinery/vending/coffee,
/turf/open/floor/plasteel,
/area/science/research)
"H" = (
/obj/structure/table/wood,
/obj/item/paper_bin,
/obj/item/pen,
/obj/effect/turf_decal/tile/neutral,
/obj/effect/turf_decal/tile/neutral{
	dir = 4
	},
/obj/effect/turf_decal/tile/neutral{
	dir = 8
	},
/turf/open/floor/plasteel,
/area/science/research)
"I" = (
/obj/structure/chair/stool,
/obj/effect/landmark/start/scientist,
/turf/open/floor/plasteel,
/area/science/research)
"J" = (
/obj/machinery/status_display/evac{
	pixel_y = -32
	},
/turf/open/floor/plasteel,
/area/science/research)
"K" = (
/obj/effect/turf_decal/tile/neutral,
/obj/effect/turf_decal/tile/neutral{
	dir = 8
	},
/obj/machinery/atmospherics/pipe/simple/supply/hidden/layer1{
	icon_state = "pipe11-1";
	dir = 5
	},
/obj/machinery/holopad,
/turf/open/floor/plasteel,
/area/science/research)
"L" = (
/obj/effect/turf_decal/tile/neutral,
/obj/effect/turf_decal/tile/neutral{
	dir = 8
	},
/obj/machinery/atmospherics/pipe/simple/supply/hidden/layer1{
	icon_state = "pipe01-1";
	dir = 10
	},
/turf/open/floor/plasteel,
/area/science/research)
"M" = (
/obj/effect/turf_decal/tile/neutral,
/obj/effect/turf_decal/tile/neutral{
	dir = 4
	},
/obj/effect/turf_decal/tile/neutral{
	dir = 8
	},
/turf/open/floor/plasteel,
/area/science/research)
"N" = (
/obj/effect/turf_decal/tile/neutral,
/obj/effect/turf_decal/tile/neutral{
	dir = 4
	},
/obj/effect/turf_decal/tile/neutral{
	dir = 8
	},
/obj/item/kirbyplants/random,
/turf/open/floor/plasteel,
/area/science/research)
"O" = (
/obj/machinery/door/firedoor,
/obj/machinery/door/airlock{
	name = "Bathroom"
	},
/obj/effect/turf_decal/stripes/line{
	dir = 8
	},
/obj/effect/turf_decal/stripes/line{
	dir = 4
	},
/obj/machinery/atmospherics/pipe/simple/supply/hidden/layer1,
/turf/open/floor/plasteel,
/area/science/research)
"P" = (
/obj/effect/turf_decal/tile/neutral{
	dir = 1
	},
/obj/effect/turf_decal/tile/neutral,
/obj/effect/turf_decal/tile/neutral{
	dir = 4
	},
/obj/effect/turf_decal/tile/neutral{
	dir = 8
	},
/turf/closed/wall,
/area/science/research)
"Q" = (
/obj/structure/toilet{
	dir = 4
	},
/obj/effect/decal/cleanable/dirt,
/obj/machinery/light/small,
/obj/machinery/newscaster{
	pixel_x = 0;
	pixel_y = 32
	},
/obj/effect/turf_decal/tile/neutral{
	dir = 1
	},
/obj/effect/turf_decal/tile/neutral,
/obj/effect/turf_decal/tile/neutral{
	dir = 4
	},
/obj/effect/turf_decal/tile/neutral{
	dir = 8
	},
/turf/open/floor/plasteel,
/area/science/research)
"R" = (
/obj/effect/decal/cleanable/dirt,
/obj/machinery/door/airlock{
	name = "Bathroom"
	},
/obj/effect/turf_decal/stripes/line,
/obj/effect/turf_decal/stripes/line{
	dir = 1
	},
/turf/open/floor/plasteel,
/area/science/research)
"S" = (
/obj/structure/mirror{
	pixel_x = 1;
	pixel_y = -30
	},
/obj/effect/decal/cleanable/dirt,
/obj/effect/landmark/blobstart,
/obj/effect/turf_decal/tile/neutral{
	dir = 4
	},
/obj/effect/turf_decal/tile/neutral{
	dir = 8
	},
/obj/effect/turf_decal/tile/neutral{
	dir = 1
	},
/obj/effect/turf_decal/tile/neutral,
/obj/structure/sink{
	pixel_x = 0;
	pixel_y = 22
	},
/turf/open/floor/plasteel,
/area/science/research)
"T" = (
/obj/machinery/atmospherics/pipe/simple/supply/hidden/layer1{
	icon_state = "pipe11-1";
	dir = 5
	},
/turf/open/floor/plasteel,
/area/science/research)
"U" = (
/obj/effect/decal/cleanable/dirt,
/obj/effect/landmark/xeno_spawn,
/obj/effect/turf_decal/tile/neutral{
	dir = 1
	},
/obj/effect/turf_decal/tile/neutral,
/obj/effect/turf_decal/tile/neutral{
	dir = 4
	},
/obj/effect/turf_decal/tile/neutral{
	dir = 8
	},
/obj/structure/urinal{
	pixel_x = 0;
	pixel_y = 27
	},
/obj/machinery/light/small{
	dir = 4
	},
/obj/machinery/atmospherics/components/unary/vent_pump/on/layer1{
	dir = 8
	},
/turf/open/floor/plasteel,
/area/science/research)

(1,1,1) = {"
a
b
j
r
r
r
r
r
r
a
"}
(2,1,1) = {"
a
c
k
s
y
C
H
r
P
a
"}
(3,1,1) = {"
a
d
l
t
z
D
I
r
Q
a
"}
(4,1,1) = {"
a
e
m
u
v
v
J
r
R
a
"}
(5,1,1) = {"
a
f
n
t
t
t
K
r
S
a
"}
(6,1,1) = {"
a
g
m
v
v
F
L
O
T
a
"}
(7,1,1) = {"
a
h
o
w
A
v
M
r
U
a
"}
(8,1,1) = {"
a
i
p
x
B
G
N
r
r
a
"}
(9,1,1) = {"
a
E
q
a
a
a
a
a
a
a
"}
