//MAP CONVERTED BY dmm2tgm.py THIS HEADER COMMENT PREVENTS RECONVERSION, DO NOT REMOVE
"cb" = (
/obj/effect/turf_decal/tile/purple{
	dir = 8
	},
/obj/effect/turf_decal/tile/purple{
	dir = 8
	},
/obj/effect/turf_decal/tile/purple{
	dir = 8
	},
/obj/effect/turf_decal/tile/purple{
	dir = 1
	},
/obj/effect/turf_decal/tile/purple{
	dir = 1
	},
/obj/effect/turf_decal/tile/purple{
	dir = 1
	},
/obj/machinery/vending/assist,
/obj/effect/turf_decal/bot,
/turf/open/floor/plasteel/white,
/area/science/circuitry)
"dX" = (
/obj/machinery/atmospherics/pipe/simple/scrubbers/hidden,
/obj/effect/turf_decal/tile/purple{
	dir = 4
	},
/obj/effect/turf_decal/tile/purple{
	dir = 4
	},
/obj/effect/turf_decal/tile/purple{
	dir = 4
	},
/obj/effect/turf_decal/tile/purple,
/obj/effect/turf_decal/tile/purple,
/obj/effect/turf_decal/tile/purple,
/obj/effect/turf_decal/box/red,
/obj/machinery/rnd/bepis,
/turf/open/floor/plasteel/white,
/area/science/circuitry)
"ek" = (
/obj/structure/cable,
/obj/machinery/light_switch{
	pixel_x = 8;
	pixel_y = 28
	},
/obj/structure/disposalpipe/junction{
	dir = 4
	},
/obj/effect/turf_decal/tile/purple{
	dir = 1
	},
/obj/effect/turf_decal/tile/purple{
	dir = 1
	},
/obj/effect/turf_decal/tile/purple{
	dir = 1
	},
/obj/effect/turf_decal/tile/purple{
	dir = 4
	},
/obj/effect/turf_decal/tile/purple{
	dir = 4
	},
/obj/effect/turf_decal/tile/purple{
	dir = 4
	},
/obj/effect/turf_decal/tile/purple{
	dir = 8
	},
/obj/effect/turf_decal/tile/purple{
	dir = 8
	},
/obj/effect/turf_decal/tile/purple{
	dir = 8
	},
/turf/open/floor/plasteel/white,
/area/science/circuitry)
"er" = (
/obj/structure/table/reinforced,
/obj/item/integrated_circuit_printer,
/obj/effect/turf_decal/tile/purple{
	dir = 8
	},
/obj/effect/turf_decal/tile/purple,
/obj/effect/turf_decal/tile/purple,
/obj/effect/turf_decal/tile/purple,
/obj/effect/turf_decal/tile/purple{
	dir = 8
	},
/obj/effect/turf_decal/tile/purple{
	dir = 8
	},
/turf/open/floor/plasteel/white,
/area/science/circuitry)
"eJ" = (
/obj/effect/landmark/event_spawn,
/turf/open/floor/plasteel/white,
/area/science/circuitry)
"fs" = (
/obj/machinery/disposal/bin,
/obj/structure/disposalpipe/trunk{
	dir = 1
	},
/obj/effect/turf_decal/tile/purple{
	dir = 8
	},
/obj/effect/turf_decal/tile/purple{
	dir = 8
	},
/obj/effect/turf_decal/tile/purple{
	dir = 8
	},
/obj/effect/turf_decal/tile/purple{
	dir = 1
	},
/obj/effect/turf_decal/tile/purple{
	dir = 1
	},
/obj/effect/turf_decal/tile/purple{
	dir = 1
	},
/turf/open/floor/plasteel/white,
/area/science/circuitry)
"gl" = (
/obj/structure/cable,
/obj/machinery/firealarm{
	pixel_y = 24
	},
/obj/structure/disposalpipe/segment{
	dir = 4
	},
/obj/effect/turf_decal/tile/purple{
	dir = 1
	},
/obj/effect/turf_decal/tile/purple{
	dir = 1
	},
/obj/effect/turf_decal/tile/purple{
	dir = 1
	},
/obj/effect/turf_decal/tile/purple{
	dir = 4
	},
/obj/effect/turf_decal/tile/purple{
	dir = 4
	},
/obj/effect/turf_decal/tile/purple{
	dir = 4
	},
/turf/open/floor/plasteel/white,
/area/science/circuitry)
"gt" = (
/turf/closed/wall/r_wall,
/area/science/circuitry)
"gx" = (
/obj/structure/cable,
/obj/structure/disposalpipe/segment{
	dir = 4
	},
/obj/machinery/airalarm{
	pixel_y = 23
	},
/obj/structure/table,
/obj/effect/turf_decal/tile/purple{
	dir = 1
	},
/obj/effect/turf_decal/tile/purple{
	dir = 1
	},
/obj/effect/turf_decal/tile/purple{
	dir = 1
	},
/obj/effect/turf_decal/tile/purple{
	dir = 4
	},
/obj/effect/turf_decal/tile/purple{
	dir = 4
	},
/obj/effect/turf_decal/tile/purple{
	dir = 4
	},
/obj/item/storage/toolbox/mechanical{
	pixel_x = 2;
	pixel_y = 3
	},
/turf/open/floor/plasteel/white,
/area/science/circuitry)
"gH" = (
/obj/structure/table/reinforced,
/obj/effect/turf_decal/tile/purple{
	dir = 8
	},
/obj/effect/turf_decal/tile/purple,
/obj/effect/turf_decal/tile/purple,
/obj/effect/turf_decal/tile/purple,
/obj/effect/turf_decal/tile/purple{
	dir = 8
	},
/obj/effect/turf_decal/tile/purple{
	dir = 8
	},
/obj/machinery/computer/security/telescreen/research{
	desc = "A telescreen with access to the circuitry lab camera network. The network ID of this one seems to be: circuitry.";
	dir = 1;
	name = "\improper Circuitry Lab monitor";
	network = list("circuitry");
	pixel_y = -27
	},
/turf/open/floor/plasteel/white,
/area/science/circuitry)
"gS" = (
/obj/structure/table/reinforced,
/obj/item/stack/sheet/metal/twenty,
/obj/effect/turf_decal/tile/purple{
	dir = 8
	},
/obj/effect/turf_decal/tile/purple,
/obj/effect/turf_decal/tile/purple,
/obj/effect/turf_decal/tile/purple,
/obj/effect/turf_decal/tile/purple{
	dir = 8
	},
/obj/effect/turf_decal/tile/purple{
	dir = 8
	},
/turf/open/floor/plasteel/white,
/area/science/circuitry)
"hH" = (
/obj/structure/cable,
/obj/structure/disposalpipe/segment{
	dir = 4
	},
/obj/machinery/camera{
	c_tag = "Circuitry Lab - North";
	network = list("ss13","rd", "circuitry")
	},
/obj/effect/turf_decal/tile/purple{
	dir = 1
	},
/obj/effect/turf_decal/tile/purple{
	dir = 1
	},
/obj/effect/turf_decal/tile/purple{
	dir = 1
	},
/obj/effect/turf_decal/tile/purple{
	dir = 4
	},
/obj/effect/turf_decal/tile/purple{
	dir = 4
	},
/obj/effect/turf_decal/tile/purple{
	dir = 4
	},
/obj/structure/closet/wardrobe/science_white,
/turf/open/floor/plasteel/white,
/area/science/circuitry)
"jm" = (
/obj/machinery/door/firedoor/heavy,
/obj/machinery/atmospherics/pipe/simple/scrubbers/hidden{
	dir = 4
	},
/obj/effect/spawner/structure/window,
/obj/machinery/atmospherics/pipe/simple/supply/hidden/layer1{
	dir = 8
	},
/turf/open/floor/plating,
/area/science/circuitry)
"ju" = (
/obj/effect/turf_decal/stripes/line{
	dir = 6
	},
/turf/open/floor/plasteel,
/area/science/circuitry)
"kD" = (
/obj/structure/cable,
/obj/structure/disposalpipe/segment{
	dir = 4
	},
/obj/effect/turf_decal/tile/purple{
	dir = 1
	},
/obj/effect/turf_decal/tile/purple{
	dir = 1
	},
/obj/effect/turf_decal/tile/purple{
	dir = 1
	},
/obj/effect/turf_decal/tile/purple{
	dir = 4
	},
/obj/effect/turf_decal/tile/purple{
	dir = 4
	},
/obj/effect/turf_decal/tile/purple{
	dir = 4
	},
/obj/item/twohanded/required/kirbyplants/random,
/turf/open/floor/plasteel/white,
/area/science/circuitry)
"kO" = (
/obj/structure/cable,
/obj/structure/disposalpipe/segment{
	dir = 4
	},
/obj/effect/turf_decal/tile/purple{
	dir = 1
	},
/obj/effect/turf_decal/tile/purple{
	dir = 1
	},
/obj/effect/turf_decal/tile/purple{
	dir = 1
	},
/obj/effect/turf_decal/tile/purple{
	dir = 4
	},
/obj/effect/turf_decal/tile/purple{
	dir = 4
	},
/obj/effect/turf_decal/tile/purple{
	dir = 4
	},
/obj/structure/table,
/obj/item/paper_bin{
	pixel_y = 6
	},
/obj/item/pen,
/obj/machinery/light{
	dir = 1
	},
/turf/open/floor/plasteel/white,
/area/science/circuitry)
"mr" = (
/obj/structure/table/reinforced,
/obj/item/integrated_circuit_printer,
/obj/effect/turf_decal/tile/purple{
	dir = 8
	},
/obj/effect/turf_decal/tile/purple{
	dir = 8
	},
/obj/effect/turf_decal/tile/purple{
	dir = 8
	},
/obj/effect/turf_decal/tile/purple,
/obj/effect/turf_decal/tile/purple,
/obj/effect/turf_decal/tile/purple,
/obj/effect/turf_decal/tile/purple{
	dir = 1
	},
/obj/effect/turf_decal/tile/purple{
	dir = 1
	},
/obj/effect/turf_decal/tile/purple{
	dir = 1
	},
/turf/open/floor/plasteel/white,
/area/science/circuitry)
"mu" = (
/obj/effect/turf_decal/stripes/line{
	dir = 9
	},
/turf/open/floor/plasteel,
/area/science/circuitry)
"nJ" = (
/obj/structure/cable,
/obj/structure/disposalpipe/segment{
	dir = 4
	},
/obj/effect/turf_decal/tile/purple,
/obj/effect/turf_decal/tile/purple,
/obj/effect/turf_decal/tile/purple,
/obj/effect/turf_decal/tile/purple{
	dir = 1
	},
/obj/effect/turf_decal/tile/purple{
	dir = 1
	},
/obj/effect/turf_decal/tile/purple{
	dir = 1
	},
/obj/effect/turf_decal/tile/purple{
	dir = 4
	},
/obj/effect/turf_decal/tile/purple{
	dir = 4
	},
/obj/effect/turf_decal/tile/purple{
	dir = 4
	},
/turf/open/floor/plasteel/white,
/area/science/circuitry)
"qw" = (
/turf/closed/wall,
/area/science/circuitry)
"sK" = (
/obj/effect/turf_decal/stripes/line{
	dir = 8
	},
/turf/open/floor/plasteel,
/area/science/circuitry)
"th" = (
/obj/structure/cable,
/obj/machinery/door/airlock/maintenance{
	name = "Circuitry Lab Maintenance";
	req_access_txt = "47"
	},
/obj/structure/disposalpipe/segment{
	dir = 4
	},
/turf/open/floor/plating,
/area/maintenance/starboard)
"uY" = (
/obj/structure/table/reinforced,
/obj/item/stack/sheet/metal/twenty,
/obj/effect/turf_decal/tile/purple{
	dir = 4
	},
/obj/effect/turf_decal/tile/purple{
	dir = 4
	},
/obj/effect/turf_decal/tile/purple{
	dir = 4
	},
/obj/effect/turf_decal/tile/purple,
/obj/effect/turf_decal/tile/purple,
/obj/effect/turf_decal/tile/purple,
/obj/machinery/computer/security/telescreen/research{
	desc = "A telescreen with access to the circuitry lab camera network. The network ID of this one seems to be: circuitry.";
	dir = 8;
	name = "\improper Circuitry Lab monitor";
	network = list("circuitry");
	pixel_x = 27
	},
/turf/open/floor/plasteel/white,
/area/science/circuitry)
"vm" = (
/obj/structure/cable,
/obj/machinery/power/apc{
	areastring = "/area/science/circuitry";
	dir = 4;
	name = "Circuitry Lab APC";
	pixel_x = 26
	},
/obj/machinery/atmospherics/pipe/manifold/scrubbers/hidden{
	dir = 1
	},
/obj/machinery/atmospherics/pipe/simple/supply/hidden/layer1{
	dir = 8
	},
/obj/effect/turf_decal/tile/purple{
	dir = 4
	},
/obj/effect/turf_decal/tile/purple{
	dir = 4
	},
/obj/effect/turf_decal/tile/purple{
	dir = 4
	},
/obj/effect/turf_decal/tile/purple,
/obj/effect/turf_decal/tile/purple,
/obj/effect/turf_decal/tile/purple,
/turf/open/floor/plasteel/white,
/area/science/circuitry)
"wA" = (
/obj/effect/landmark/blobstart,
/obj/effect/landmark/xeno_spawn,
/turf/open/floor/plasteel,
/area/science/circuitry)
"xf" = (
/obj/structure/table/reinforced,
/obj/item/integrated_electronics/debugger{
	pixel_x = 4;
	pixel_y = 4
	},
/obj/item/integrated_electronics/wirer,
/obj/item/multitool{
	pixel_x = -5;
	pixel_y = -5
	},
/obj/item/screwdriver,
/turf/open/floor/plasteel/white,
/area/science/circuitry)
"xD" = (
/obj/effect/turf_decal/stripes/line{
	dir = 4
	},
/turf/open/floor/plasteel,
/area/science/circuitry)
"zI" = (
/obj/machinery/atmospherics/components/unary/vent_pump/on/layer1{
	dir = 1
	},
/turf/open/floor/plasteel/white,
/area/science/circuitry)
"zO" = (
/obj/effect/turf_decal/stripes/line{
	dir = 10
	},
/turf/open/floor/plasteel,
/area/science/circuitry)
"AA" = (
/obj/structure/cable,
/obj/machinery/door/airlock/research{
	name = "Circuitry Lab";
	req_access_txt = "47"
	},
/obj/structure/disposalpipe/segment{
	dir = 4
	},
/turf/open/floor/plasteel/white,
/area/science/circuitry)
"AW" = (
/obj/effect/turf_decal/tile/purple{
	dir = 4
	},
/obj/effect/turf_decal/tile/purple{
	dir = 4
	},
/obj/effect/turf_decal/tile/purple{
	dir = 4
	},
/obj/effect/turf_decal/tile/purple,
/obj/effect/turf_decal/tile/purple,
/obj/effect/turf_decal/tile/purple,
/obj/machinery/autolathe,
/obj/effect/turf_decal/bot,
/turf/open/floor/plasteel/white,
/area/science/circuitry)
"Bl" = (
/obj/machinery/atmospherics/components/unary/vent_scrubber/on{
	dir = 1
	},
/obj/effect/turf_decal/tile/purple{
	dir = 4
	},
/obj/effect/turf_decal/tile/purple{
	dir = 4
	},
/obj/effect/turf_decal/tile/purple{
	dir = 4
	},
/obj/effect/turf_decal/tile/purple,
/obj/effect/turf_decal/tile/purple,
/obj/effect/turf_decal/tile/purple,
/obj/structure/table,
/obj/item/storage/bag/money,
/turf/open/floor/plasteel/white,
/area/science/circuitry)
"Bu" = (
/obj/structure/table/reinforced,
/obj/item/multitool{
	pixel_x = -3;
	pixel_y = 2
	},
/obj/item/stock_parts/cell/high{
	pixel_x = -2;
	pixel_y = 2
	},
/obj/item/stock_parts/cell/high{
	pixel_x = 2;
	pixel_y = -2
	},
/obj/item/screwdriver,
/turf/open/floor/plasteel/white,
/area/science/circuitry)
"BE" = (
/obj/machinery/atmospherics/pipe/simple/scrubbers/hidden{
	dir = 4
	},
/obj/machinery/atmospherics/pipe/simple/supply/hidden/layer1{
	dir = 8
	},
/turf/open/floor/plasteel/white,
/area/science/circuitry)
"BG" = (
/obj/machinery/atmospherics/pipe/simple/scrubbers/hidden{
	dir = 4
	},
/obj/machinery/atmospherics/pipe/manifold/supply/hidden/layer1{
	dir = 1
	},
/turf/open/floor/plasteel/white,
/area/science/circuitry)
"Do" = (
/obj/structure/table/reinforced,
/obj/item/stock_parts/cell/high{
	pixel_x = 3;
	pixel_y = 3
	},
/obj/item/stock_parts/cell/high{
	pixel_x = -1;
	pixel_y = -1
	},
/obj/effect/turf_decal/tile/purple{
	dir = 8
	},
/obj/effect/turf_decal/tile/purple{
	dir = 8
	},
/obj/effect/turf_decal/tile/purple{
	dir = 8
	},
/obj/effect/turf_decal/tile/purple{
	dir = 1
	},
/obj/effect/turf_decal/tile/purple{
	dir = 1
	},
/obj/effect/turf_decal/tile/purple{
	dir = 1
	},
/turf/open/floor/plasteel/white,
/area/science/circuitry)
"DT" = (
/obj/effect/turf_decal/stripes/line{
	dir = 5
	},
/turf/open/floor/plasteel,
/area/science/circuitry)
"FK" = (
/obj/machinery/holopad,
/obj/machinery/atmospherics/pipe/simple/scrubbers/hidden{
	dir = 4
	},
/obj/machinery/atmospherics/pipe/simple/supply/hidden/layer1{
	dir = 8
	},
/turf/open/floor/plasteel/white,
/area/science/circuitry)
"Gl" = (
/obj/structure/table/reinforced,
/obj/item/paper_bin{
	pixel_y = 6
	},
/obj/item/pen,
/obj/effect/turf_decal/tile/purple{
	dir = 4
	},
/obj/effect/turf_decal/tile/purple{
	dir = 4
	},
/obj/effect/turf_decal/tile/purple{
	dir = 4
	},
/obj/effect/turf_decal/tile/purple{
	dir = 8
	},
/obj/effect/turf_decal/tile/purple{
	dir = 8
	},
/obj/effect/turf_decal/tile/purple{
	dir = 8
	},
/obj/effect/turf_decal/tile/purple,
/obj/effect/turf_decal/tile/purple,
/obj/effect/turf_decal/tile/purple,
/turf/open/floor/plasteel/white,
/area/science/circuitry)
"GX" = (
/obj/machinery/atmospherics/pipe/simple/scrubbers/hidden{
	dir = 4
	},
/obj/machinery/atmospherics/pipe/simple/supply/hidden/layer1{
	dir = 8
	},
/turf/closed/wall/r_wall,
/area/science/circuitry)
"Hf" = (
/obj/structure/chair/office/light{
	dir = 4
	},
/turf/open/floor/plasteel/white,
/area/science/circuitry)
"Hy" = (
/turf/open/floor/plasteel/white,
/area/science/circuitry)
"IC" = (
/obj/structure/table/reinforced,
/obj/item/integrated_electronics/debugger{
	pixel_x = -5;
	pixel_y = 2
	},
/obj/item/integrated_electronics/wirer,
/obj/effect/turf_decal/tile/purple{
	dir = 8
	},
/obj/effect/turf_decal/tile/purple,
/obj/effect/turf_decal/tile/purple,
/obj/effect/turf_decal/tile/purple,
/obj/effect/turf_decal/tile/purple{
	dir = 8
	},
/obj/effect/turf_decal/tile/purple{
	dir = 8
	},
/turf/open/floor/plasteel/white,
/area/science/circuitry)
"MI" = (
/obj/effect/turf_decal/stripes/line{
	dir = 1
	},
/turf/open/floor/plasteel,
/area/science/circuitry)
"NR" = (
/obj/structure/chair/office/light,
/obj/effect/landmark/start/scientist,
/turf/open/floor/plasteel/white,
/area/science/circuitry)
"Uy" = (
/obj/structure/table/reinforced,
/obj/item/integrated_electronics/analyzer,
/obj/effect/turf_decal/tile/purple{
	dir = 4
	},
/obj/effect/turf_decal/tile/purple{
	dir = 4
	},
/obj/effect/turf_decal/tile/purple{
	dir = 4
	},
/obj/effect/turf_decal/tile/purple,
/obj/effect/turf_decal/tile/purple,
/obj/effect/turf_decal/tile/purple,
/turf/open/floor/plasteel/white,
/area/science/circuitry)
"UT" = (
/obj/effect/turf_decal/stripes/line,
/turf/open/floor/plasteel,
/area/science/circuitry)
"UY" = (
/obj/structure/disposalpipe/segment,
/obj/effect/turf_decal/tile/purple{
	dir = 8
	},
/obj/effect/turf_decal/tile/purple{
	dir = 8
	},
/obj/effect/turf_decal/tile/purple{
	dir = 8
	},
/obj/effect/turf_decal/tile/purple{
	dir = 1
	},
/obj/effect/turf_decal/tile/purple{
	dir = 1
	},
/obj/effect/turf_decal/tile/purple{
	dir = 1
	},
/obj/item/twohanded/required/kirbyplants/random,
/turf/open/floor/plasteel/white,
/area/science/circuitry)
"Wu" = (
/obj/machinery/camera{
	c_tag = "Circuitry Lab - South";
	dir = 1;
	network = list("ss13","rd", "circuitry")
	},
/obj/machinery/light,
/obj/structure/sign/warning/nosmoking{
	pixel_y = -32
	},
/obj/item/twohanded/required/kirbyplants/random,
/obj/effect/turf_decal/tile/purple,
/obj/effect/turf_decal/tile/purple,
/obj/effect/turf_decal/tile/purple,
/obj/effect/turf_decal/tile/purple{
	dir = 8
	},
/obj/effect/turf_decal/tile/purple{
	dir = 8
	},
/obj/effect/turf_decal/tile/purple{
	dir = 8
	},
/turf/open/floor/plasteel/white,
/area/science/circuitry)
"WP" = (
/obj/machinery/atmospherics/pipe/simple/scrubbers/hidden{
	dir = 4
	},
/obj/structure/disposalpipe/segment,
/obj/machinery/atmospherics/pipe/simple/supply/hidden/layer1{
	dir = 8
	},
/obj/effect/turf_decal/tile/purple{
	dir = 8
	},
/obj/effect/turf_decal/tile/purple{
	dir = 8
	},
/obj/effect/turf_decal/tile/purple{
	dir = 8
	},
/obj/effect/turf_decal/tile/purple{
	dir = 1
	},
/obj/effect/turf_decal/tile/purple{
	dir = 1
	},
/obj/effect/turf_decal/tile/purple{
	dir = 1
	},
/turf/open/floor/plasteel/white,
/area/science/circuitry)
"Xr" = (
/obj/structure/table/reinforced,
/obj/item/paper_bin{
	pixel_y = 6
	},
/obj/item/pen,
/obj/effect/turf_decal/tile/purple{
	dir = 8
	},
/obj/effect/turf_decal/tile/purple{
	dir = 8
	},
/obj/effect/turf_decal/tile/purple{
	dir = 8
	},
/obj/effect/turf_decal/tile/purple{
	dir = 1
	},
/obj/effect/turf_decal/tile/purple{
	dir = 1
	},
/obj/effect/turf_decal/tile/purple{
	dir = 1
	},
/turf/open/floor/plasteel/white,
/area/science/circuitry)

(1,1,1) = {"
gt
AA
jm
qw
qw
qw
qw
qw
qw
gt
"}
(2,1,1) = {"
gt
ek
WP
UY
fs
cb
Do
Xr
mr
gt
"}
(3,1,1) = {"
gt
gl
BG
zI
Hy
Hy
Hy
NR
gH
gt
"}
(4,1,1) = {"
gt
hH
BE
mu
sK
zO
Hy
xf
gS
gt
"}
(5,1,1) = {"
gt
kO
BE
MI
wA
UT
Hy
Hy
Wu
gt
"}
(6,1,1) = {"
gt
gx
BE
DT
xD
ju
Hy
Bu
IC
gt
"}
(7,1,1) = {"
gt
kD
FK
Hf
Hy
Hy
eJ
NR
er
gt
"}
(8,1,1) = {"
gt
nJ
vm
dX
Bl
AW
Uy
uY
Gl
gt
"}
(9,1,1) = {"
gt
th
GX
gt
gt
gt
gt
gt
gt
gt
"}
