//MAP CONVERTED BY dmm2tgm.py THIS HEADER COMMENT PREVENTS RECONVERSION, DO NOT REMOVE
"a" = (
/turf/closed/wall/r_wall,
/area/science/explab)
"b" = (
/obj/structure/cable,
/obj/machinery/door/airlock/research{
	name = "Experimentation Lab";
	req_access_txt = "47"
	},
/obj/structure/disposalpipe/segment{
	dir = 4
	},
/turf/open/floor/plasteel/white,
/area/science/explab)
"c" = (
/obj/structure/cable,
/obj/machinery/light_switch{
	pixel_x = 8;
	pixel_y = 28
	},
/obj/structure/disposalpipe/junction{
	dir = 4
	},
/turf/open/floor/plasteel/white,
/area/science/explab)
"d" = (
/obj/structure/cable,
/obj/machinery/firealarm{
	pixel_y = 24
	},
/obj/structure/disposalpipe/segment{
	dir = 4
	},
/obj/machinery/light{
	dir = 1
	},
/turf/open/floor/plasteel/white,
/area/science/explab)
"e" = (
/obj/structure/cable,
/obj/structure/disposalpipe/segment{
	dir = 4
	},
/obj/machinery/camera{
	c_tag = "Experimentor Lab";
	network = list("ss13","rd")
	},
/obj/structure/closet/l3closet/scientist,
/turf/open/floor/plasteel/white,
/area/science/explab)
"f" = (
/obj/structure/cable,
/obj/structure/disposalpipe/segment{
	dir = 4
	},
/obj/structure/table,
/obj/item/paper_bin{
	pixel_y = 6
	},
/obj/item/pen,
/turf/open/floor/plasteel/white,
/area/science/explab)
"g" = (
/obj/structure/cable,
/obj/structure/disposalpipe/segment{
	dir = 4
	},
/obj/machinery/airalarm{
	pixel_y = 23
	},
/obj/structure/table,
/obj/item/storage/toolbox/mechanical{
	pixel_x = 2;
	pixel_y = 3
	},
/turf/open/floor/plasteel/white,
/area/science/explab)
"h" = (
/obj/structure/cable,
/obj/structure/disposalpipe/segment{
	dir = 4
	},
/turf/open/floor/plasteel/white,
/area/science/explab)
"i" = (
/obj/structure/cable,
/obj/machinery/door/airlock/maintenance{
	name = "Experimentation Lab Maintenance";
	req_access_txt = "47"
	},
/obj/structure/disposalpipe/segment{
	dir = 4
	},
/turf/open/floor/plating,
/area/maintenance/starboard)
"j" = (
/obj/machinery/door/firedoor/heavy,
/obj/machinery/atmospherics/pipe/simple/scrubbers/hidden{
	dir = 4
	},
/obj/effect/spawner/structure/window,
/obj/machinery/atmospherics/pipe/simple/supply/hidden/layer1{
	dir = 8
	},
/turf/open/floor/plating,
/area/science/explab)
"k" = (
/obj/machinery/atmospherics/pipe/simple/scrubbers/hidden{
	dir = 4
	},
/obj/structure/disposalpipe/segment,
/obj/machinery/atmospherics/pipe/simple/supply/hidden/layer1{
	dir = 8
	},
/turf/open/floor/plasteel/white,
/area/science/explab)
"l" = (
/obj/machinery/atmospherics/pipe/simple/scrubbers/hidden{
	dir = 4
	},
/obj/machinery/atmospherics/pipe/manifold/supply/hidden/layer1{
	dir = 1
	},
/turf/open/floor/plasteel/white,
/area/science/explab)
"m" = (
/obj/machinery/atmospherics/pipe/simple/scrubbers/hidden{
	dir = 4
	},
/obj/machinery/atmospherics/pipe/simple/supply/hidden/layer1{
	dir = 8
	},
/turf/open/floor/plasteel/white,
/area/science/explab)
"n" = (
/obj/machinery/holopad,
/obj/machinery/atmospherics/pipe/simple/scrubbers/hidden{
	dir = 4
	},
/obj/machinery/atmospherics/pipe/simple/supply/hidden/layer1{
	dir = 8
	},
/turf/open/floor/plasteel/white,
/area/science/explab)
"o" = (
/obj/structure/cable,
/obj/machinery/power/apc{
	areastring = "/area/science/explab";
	dir = 4;
	name = "Experimentation Lab APC";
	pixel_x = 26
	},
/obj/machinery/atmospherics/pipe/manifold/scrubbers/hidden{
	dir = 1
	},
/obj/machinery/atmospherics/pipe/simple/supply/hidden/layer1{
	dir = 8
	},
/turf/open/floor/plasteel/white,
/area/science/explab)
"p" = (
/obj/machinery/atmospherics/pipe/simple/scrubbers/hidden{
	dir = 4
	},
/obj/machinery/atmospherics/pipe/simple/supply/hidden/layer1{
	dir = 8
	},
/turf/closed/wall/r_wall,
/area/science/explab)
"q" = (
/turf/closed/wall,
/area/science/explab)
"r" = (
/obj/structure/disposalpipe/segment,
/turf/open/floor/plasteel/white,
/area/science/explab)
"s" = (
/obj/machinery/atmospherics/components/unary/vent_pump/on/layer1{
	dir = 1
	},
/turf/open/floor/plasteel/white,
/area/science/explab)
"t" = (
/turf/open/floor/plasteel/white,
/area/science/explab)
"u" = (
/obj/structure/chair/office/light,
/obj/effect/landmark/start/scientist,
/turf/open/floor/plasteel/white,
/area/science/explab)
"v" = (
/obj/machinery/atmospherics/pipe/simple/scrubbers/hidden,
/turf/open/floor/plasteel/white,
/area/science/explab)
"w" = (
/obj/machinery/disposal/bin,
/obj/structure/disposalpipe/trunk{
	dir = 1
	},
/turf/open/floor/plasteel/white/corner{
	dir = 4
	},
/area/science/explab)
"x" = (
/obj/structure/closet/radiation,
/turf/open/floor/plasteel/white/corner{
	dir = 1
	},
/area/science/explab)
"y" = (
/obj/structure/table,
/obj/item/clipboard,
/obj/item/book/manual/wiki/experimentor,
/turf/open/floor/plasteel/white/corner{
	dir = 4
	},
/area/science/explab)
"z" = (
/obj/machinery/computer/rdconsole/experiment{
	dir = 1
	},
/turf/open/floor/plasteel/white/corner{
	dir = 1
	},
/area/science/explab)
"A" = (
/obj/machinery/button/door{
	id = "telelab";
	name = "Test Chamber Blast Doors";
	pixel_x = 25;
	req_access_txt = "47"
	},
/obj/effect/turf_decal/stripes/line,
/obj/machinery/atmospherics/components/unary/vent_scrubber/on{
	dir = 1
	},
/turf/open/floor/plasteel/white,
/area/science/explab)
"B" = (
/obj/machinery/door/poddoor/preopen{
	id = "telelab";
	name = "test chamber blast door"
	},
/obj/effect/spawner/structure/window/reinforced,
/obj/machinery/door/firedoor/heavy,
/turf/open/floor/engine,
/area/science/explab)
"C" = (
/obj/machinery/door/poddoor/preopen{
	id = "telelab";
	name = "test chamber blast door"
	},
/obj/machinery/door/firedoor/heavy,
/turf/open/floor/engine,
/area/science/explab)
"D" = (
/turf/open/floor/engine,
/area/science/explab)
"E" = (
/obj/effect/turf_decal/stripes/corner,
/turf/open/floor/engine,
/area/science/explab)
"F" = (
/obj/effect/turf_decal/stripes/line,
/turf/open/floor/engine,
/area/science/explab)
"G" = (
/obj/effect/turf_decal/stripes/corner{
	dir = 8
	},
/turf/open/floor/engine,
/area/science/explab)
"H" = (
/obj/effect/landmark/event_spawn,
/turf/open/floor/engine,
/area/science/explab)
"I" = (
/obj/effect/turf_decal/stripes/line{
	dir = 4
	},
/turf/open/floor/engine,
/area/science/explab)
"J" = (
/obj/machinery/rnd/experimentor,
/turf/open/floor/plating,
/area/science/explab)
"K" = (
/obj/effect/landmark/blobstart,
/obj/effect/landmark/xeno_spawn,
/turf/open/floor/plating,
/area/science/explab)
"L" = (
/obj/effect/turf_decal/stripes/line{
	dir = 8
	},
/turf/open/floor/engine,
/area/science/explab)
"M" = (
/obj/effect/turf_decal/stripes/corner{
	dir = 4
	},
/turf/open/floor/engine,
/area/science/explab)
"N" = (
/obj/effect/turf_decal/stripes/line{
	dir = 1
	},
/turf/open/floor/engine,
/area/science/explab)
"O" = (
/obj/machinery/camera{
	c_tag = "Experimentor Lab Chamber";
	dir = 1;
	network = list("ss13","rd")
	},
/obj/machinery/light,
/obj/structure/sign/warning/nosmoking{
	pixel_y = -32
	},
/obj/effect/turf_decal/stripes/line{
	dir = 1
	},
/turf/open/floor/engine,
/area/science/explab)
"P" = (
/obj/effect/turf_decal/stripes/corner{
	dir = 1
	},
/turf/open/floor/engine,
/area/science/explab)

(1,1,1) = {"
a
b
j
q
a
a
a
a
a
a
"}
(2,1,1) = {"
a
c
k
r
w
B
D
D
D
a
"}
(3,1,1) = {"
a
d
l
s
x
B
E
I
M
a
"}
(4,1,1) = {"
a
e
m
t
q
a
F
J
N
a
"}
(5,1,1) = {"
a
f
m
t
y
B
F
K
O
a
"}
(6,1,1) = {"
a
g
m
u
z
B
G
L
P
a
"}
(7,1,1) = {"
a
h
n
t
q
a
H
D
D
a
"}
(8,1,1) = {"
a
h
o
v
A
C
D
D
D
a
"}
(9,1,1) = {"
a
i
p
a
a
a
a
a
a
a
"}
