//MAP CONVERTED BY dmm2tgm.py THIS HEADER COMMENT PREVENTS RECONVERSION, DO NOT REMOVE
"b" = (
/turf/closed/wall/r_wall,
/area/science/telesci)
"c" = (
/obj/structure/cable,
/obj/machinery/door/airlock/research{
	name = "Telescience Lab";
	req_access_txt = "47"
	},
/obj/structure/disposalpipe/segment{
	dir = 4
	},
/turf/open/floor/plasteel/white,
/area/science/telesci)
"d" = (
/obj/structure/cable,
/obj/machinery/light_switch{
	pixel_x = 8;
	pixel_y = 28
	},
/obj/structure/disposalpipe/junction{
	dir = 4
	},
/obj/effect/turf_decal/tile/purple{
	dir = 4
	},
/obj/effect/turf_decal/tile/purple{
	dir = 1
	},
/obj/effect/turf_decal/tile/purple{
	dir = 8
	},
/turf/open/floor/plasteel/white,
/area/science/telesci)
"e" = (
/obj/structure/cable,
/obj/machinery/firealarm{
	pixel_y = 24
	},
/obj/structure/disposalpipe/segment{
	dir = 4
	},
/obj/machinery/light{
	dir = 1
	},
/obj/effect/turf_decal/tile/purple{
	dir = 4
	},
/obj/effect/turf_decal/tile/purple{
	dir = 1
	},
/turf/open/floor/plasteel/white,
/area/science/telesci)
"f" = (
/obj/structure/cable,
/obj/structure/disposalpipe/segment{
	dir = 4
	},
/obj/machinery/camera{
	c_tag = "Telescience Lab";
	network = list("ss13","rd")
	},
/obj/structure/closet/l3closet/scientist,
/obj/effect/turf_decal/tile/purple{
	dir = 4
	},
/obj/effect/turf_decal/tile/purple{
	dir = 1
	},
/turf/open/floor/plasteel/white,
/area/science/telesci)
"g" = (
/obj/structure/cable,
/obj/structure/disposalpipe/segment{
	dir = 4
	},
/obj/structure/table,
/obj/item/paper_bin{
	pixel_y = 6
	},
/obj/item/pen,
/obj/effect/turf_decal/tile/purple{
	dir = 4
	},
/obj/effect/turf_decal/tile/purple{
	dir = 1
	},
/turf/open/floor/plasteel/white,
/area/science/telesci)
"h" = (
/obj/structure/cable,
/obj/structure/disposalpipe/segment{
	dir = 4
	},
/obj/machinery/airalarm{
	pixel_y = 23
	},
/obj/structure/table,
/obj/item/storage/toolbox/mechanical{
	pixel_x = 2;
	pixel_y = 3
	},
/obj/item/gps/science{
	gpstag = "SCI01"
	},
/obj/effect/turf_decal/tile/purple{
	dir = 4
	},
/obj/effect/turf_decal/tile/purple{
	dir = 1
	},
/turf/open/floor/plasteel/white,
/area/science/telesci)
"i" = (
/obj/structure/cable,
/obj/structure/disposalpipe/segment{
	dir = 4
	},
/obj/effect/turf_decal/tile/purple{
	dir = 4
	},
/obj/effect/turf_decal/tile/purple{
	dir = 1
	},
/turf/open/floor/plasteel/white,
/area/science/telesci)
"j" = (
/obj/structure/cable,
/obj/structure/disposalpipe/segment{
	dir = 4
	},
/obj/effect/turf_decal/tile/purple,
/obj/effect/turf_decal/tile/purple{
	dir = 4
	},
/obj/effect/turf_decal/tile/purple{
	dir = 1
	},
/turf/open/floor/plasteel/white,
/area/science/telesci)
"k" = (
/obj/structure/cable,
/obj/machinery/door/airlock/maintenance{
	name = "Telescience Lab Maintenance";
	req_access_txt = "47"
	},
/obj/structure/disposalpipe/segment{
	dir = 4
	},
/turf/open/floor/plating,
/area/maintenance/starboard)
"l" = (
/obj/machinery/door/firedoor/heavy,
/obj/machinery/atmospherics/pipe/simple/scrubbers/hidden{
	dir = 4
	},
/obj/machinery/atmospherics/pipe/simple/supply/hidden/layer1{
	dir = 8
	},
/obj/structure/cable,
/obj/effect/spawner/structure/window/reinforced,
/turf/open/floor/plating,
/area/science/telesci)
"m" = (
/obj/machinery/atmospherics/pipe/simple/scrubbers/hidden{
	dir = 4
	},
/obj/structure/disposalpipe/segment,
/obj/machinery/atmospherics/pipe/simple/supply/hidden/layer1{
	dir = 8
	},
/obj/effect/turf_decal/tile/purple{
	dir = 8
	},
/obj/effect/turf_decal/tile/purple{
	dir = 1
	},
/turf/open/floor/plasteel/white,
/area/science/telesci)
"n" = (
/obj/machinery/atmospherics/pipe/simple/scrubbers/hidden{
	dir = 4
	},
/obj/machinery/atmospherics/pipe/manifold/supply/hidden/layer1{
	dir = 1
	},
/turf/open/floor/plasteel/white,
/area/science/telesci)
"o" = (
/obj/machinery/atmospherics/pipe/simple/scrubbers/hidden{
	dir = 4
	},
/obj/machinery/atmospherics/pipe/simple/supply/hidden/layer1{
	dir = 8
	},
/turf/open/floor/plasteel/white,
/area/science/telesci)
"p" = (
/obj/machinery/atmospherics/pipe/simple/scrubbers/hidden{
	dir = 4
	},
/obj/machinery/atmospherics/pipe/simple/supply/hidden/layer1{
	dir = 8
	},
/obj/structure/cable,
/obj/machinery/holopad,
/turf/open/floor/plasteel/white,
/area/science/telesci)
"q" = (
/obj/structure/cable,
/obj/machinery/power/apc{
	areastring = "/area/science/telesci";
	dir = 4;
	name = "Telescience Lab APC";
	pixel_x = 26
	},
/obj/machinery/atmospherics/pipe/manifold/scrubbers/hidden{
	dir = 1
	},
/obj/machinery/atmospherics/pipe/simple/supply/hidden/layer1{
	dir = 8
	},
/obj/effect/turf_decal/tile/purple,
/obj/effect/turf_decal/tile/purple{
	dir = 4
	},
/turf/open/floor/plasteel/white,
/area/science/telesci)
"r" = (
/obj/machinery/atmospherics/pipe/simple/scrubbers/hidden{
	dir = 4
	},
/obj/machinery/atmospherics/pipe/simple/supply/hidden/layer1{
	dir = 8
	},
/turf/closed/wall/r_wall,
/area/science/telesci)
"s" = (
/obj/structure/disposalpipe/segment,
/obj/effect/turf_decal/tile/purple{
	dir = 8
	},
/obj/effect/turf_decal/tile/purple{
	dir = 1
	},
/turf/open/floor/plasteel/white,
/area/science/telesci)
"t" = (
/obj/machinery/atmospherics/components/unary/vent_pump/on/layer1{
	dir = 1
	},
/turf/open/floor/plasteel/white,
/area/science/telesci)
"u" = (
/turf/open/floor/plasteel/white,
/area/science/telesci)
"v" = (
/obj/structure/cable,
/obj/structure/chair/office/light,
/obj/effect/landmark/start/scientist,
/turf/open/floor/plasteel/white,
/area/science/telesci)
"w" = (
/obj/machinery/computer/security/telescreen{
	dir = 1;
	name = "Telescience Chamber Monitor";
	network = list("telesci");
	pixel_y = -25
	},
/turf/open/floor/plasteel/white,
/area/science/telesci)
"x" = (
/obj/machinery/atmospherics/pipe/simple/scrubbers/hidden,
/obj/effect/turf_decal/tile/purple,
/obj/effect/turf_decal/tile/purple{
	dir = 4
	},
/turf/open/floor/plasteel/white,
/area/science/telesci)
"y" = (
/obj/machinery/disposal/bin,
/obj/structure/disposalpipe/trunk{
	dir = 1
	},
/obj/effect/turf_decal/tile/purple,
/obj/effect/turf_decal/tile/purple{
	dir = 8
	},
/obj/effect/turf_decal/tile/purple{
	dir = 1
	},
/turf/open/floor/plasteel/white,
/area/science/telesci)
"z" = (
/obj/structure/closet/radiation,
/obj/effect/turf_decal/tile/purple,
/obj/effect/turf_decal/tile/purple{
	dir = 8
	},
/turf/open/floor/plasteel/white,
/area/science/telesci)
"A" = (
/obj/structure/table,
/obj/item/clipboard,
/obj/item/book/manual/wiki/telescience,
/obj/effect/turf_decal/tile/purple,
/obj/effect/turf_decal/tile/purple{
	dir = 8
	},
/turf/open/floor/plasteel/white,
/area/science/telesci)
"B" = (
/obj/structure/cable,
/obj/machinery/computer/telescience{
	dir = 1
	},
/obj/effect/turf_decal/tile/purple,
/obj/effect/turf_decal/tile/purple{
	dir = 8
	},
/turf/open/floor/plasteel/white,
/area/science/telesci)
"C" = (
/obj/structure/table,
/obj/item/paper{
	info = "<h2>How to link your telepad</h2><br> <b>1: </b>Use screwdriver on telepad<br> <b>2: </b>Use the multitool on telepad to save the buff on it<br> <b>3: </b>And then use multitool on the console to link it<br> <b>5: </b>Done, the telepad and the console are linked!";
	name = "telepad guide"
	},
/obj/item/multitool,
/obj/effect/turf_decal/tile/purple,
/obj/effect/turf_decal/tile/purple{
	dir = 8
	},
/obj/effect/turf_decal/tile/purple{
	dir = 4
	},
/turf/open/floor/plasteel/white,
/area/science/telesci)
"D" = (
/obj/machinery/button/door{
	id = "telelab";
	name = "Test Chamber Blast Doors";
	pixel_x = 25;
	req_access_txt = "47"
	},
/obj/machinery/atmospherics/components/unary/vent_scrubber/on{
	dir = 1
	},
/obj/effect/turf_decal/tile/purple{
	dir = 4
	},
/obj/effect/turf_decal/tile/purple,
/obj/effect/turf_decal/tile/purple{
	dir = 8
	},
/obj/effect/turf_decal/stripes/line,
/turf/open/floor/plasteel/white,
/area/science/telesci)
"E" = (
/obj/machinery/door/poddoor/preopen{
	id = "telelab";
	name = "test chamber blast door"
	},
/obj/effect/spawner/structure/window/reinforced,
/obj/machinery/door/firedoor/heavy,
/obj/structure/cable,
/turf/open/floor/engine,
/area/science/telesci)
"F" = (
/obj/structure/cable,
/obj/effect/spawner/structure/window/reinforced,
/obj/machinery/door/firedoor/heavy,
/obj/machinery/door/poddoor/preopen{
	id = "telelab";
	name = "test chamber blast door"
	},
/turf/open/floor/engine,
/area/science/telesci)
"G" = (
/obj/machinery/door/poddoor/preopen{
	id = "telelab";
	name = "test chamber blast door"
	},
/obj/machinery/door/firedoor/heavy,
/obj/effect/turf_decal/caution,
/turf/open/floor/engine,
/area/science/telesci)
"H" = (
/obj/effect/turf_decal/box/corners{
	dir = 1
	},
/turf/open/floor/engine,
/area/science/telesci)
"I" = (
/turf/open/floor/engine,
/area/science/telesci)
"J" = (
/obj/effect/turf_decal/stripes/corner,
/turf/open/floor/engine,
/area/science/telesci)
"K" = (
/obj/effect/turf_decal/stripes/line,
/turf/open/floor/engine,
/area/science/telesci)
"L" = (
/obj/effect/turf_decal/stripes/corner{
	dir = 8
	},
/turf/open/floor/engine,
/area/science/telesci)
"M" = (
/obj/effect/landmark/event_spawn,
/turf/open/floor/engine,
/area/science/telesci)
"N" = (
/obj/effect/turf_decal/box/corners{
	dir = 4
	},
/turf/open/floor/engine,
/area/science/telesci)
"O" = (
/obj/machinery/light/floor,
/obj/effect/turf_decal/box,
/turf/open/floor/engine,
/area/science/telesci)
"P" = (
/obj/effect/turf_decal/stripes/line{
	dir = 4
	},
/turf/open/floor/engine,
/area/science/telesci)
"Q" = (
/obj/machinery/telepad,
/obj/item/gps/science{
	gpstag = "Telesci"
	},
/turf/open/floor/engine,
/area/science/telesci)
"R" = (
/obj/effect/turf_decal/stripes/line{
	dir = 8
	},
/turf/open/floor/engine,
/area/science/telesci)
"S" = (
/obj/effect/turf_decal/box/corners{
	dir = 8
	},
/turf/open/floor/engine,
/area/science/telesci)
"T" = (
/obj/effect/landmark/blobstart,
/obj/effect/landmark/xeno_spawn,
/obj/effect/turf_decal/stripes/corner{
	dir = 4
	},
/turf/open/floor/engine,
/area/science/telesci)
"U" = (
/obj/machinery/camera{
	c_tag = "Telescience Lab Chamber";
	dir = 1;
	network = list("ss13","rd","telesci")
	},
/obj/machinery/light,
/obj/structure/sign/warning/nosmoking{
	pixel_y = -32
	},
/obj/effect/turf_decal/stripes/line{
	dir = 1
	},
/turf/open/floor/engine,
/area/science/telesci)
"V" = (
/obj/effect/turf_decal/stripes/corner{
	dir = 1
	},
/turf/open/floor/engine,
/area/science/telesci)
"W" = (
/obj/effect/turf_decal/box/corners,
/turf/open/floor/engine,
/area/science/telesci)

(1,1,1) = {"
b
c
l
b
b
b
b
b
b
b
"}
(2,1,1) = {"
b
d
m
s
y
E
H
I
S
b
"}
(3,1,1) = {"
b
e
n
t
z
E
I
O
I
b
"}
(4,1,1) = {"
b
f
o
u
A
F
J
P
T
b
"}
(5,1,1) = {"
b
g
p
v
B
E
K
Q
U
b
"}
(6,1,1) = {"
b
h
o
u
C
E
L
R
V
b
"}
(7,1,1) = {"
b
i
o
w
b
b
M
O
I
b
"}
(8,1,1) = {"
b
j
q
x
D
G
N
I
W
b
"}
(9,1,1) = {"
b
k
r
b
b
b
b
b
b
b
"}
