//MAP CONVERTED BY dmm2tgm.py THIS HEADER COMMENT PREVENTS RECONVERSION, DO NOT REMOVE
"aa" = (
/turf/closed/wall,
/area/maintenance/starboard/aft)
"ab" = (
/turf/template_noop,
/area/template_noop)
"ac" = (
/obj/structure/lattice,
/turf/open/space,
/area/space/nearstation)
"ad" = (
/obj/structure/cable,
/obj/structure/disposalpipe/segment,
/obj/machinery/atmospherics/pipe/simple/scrubbers/hidden,
/obj/machinery/atmospherics/pipe/simple/supply/hidden/layer1{
	dir = 1
	},
/turf/open/floor/plating,
/area/maintenance/starboard/aft)
"ah" = (
/obj/structure/disposalpipe/segment,
/turf/open/floor/plating/airless,
/area/space/nearstation)
"ai" = (
/obj/structure/cable,
/obj/structure/disposalpipe/segment{
	dir = 4
	},
/obj/effect/landmark/event_spawn,
/turf/open/floor/plating,
/area/maintenance/starboard/aft)
"aj" = (
/obj/effect/spawner/structure/window/reinforced,
/turf/open/floor/plating,
/area/maintenance/starboard/aft)
"ak" = (
/obj/structure/cable,
/turf/open/floor/plating,
/area/maintenance/starboard/aft)
"al" = (
/obj/effect/spawner/structure/window/reinforced,
/obj/structure/disposalpipe/segment,
/turf/open/floor/plating,
/area/maintenance/starboard/aft)
"ao" = (
/obj/structure/disposalpipe/segment{
	dir = 4
	},
/obj/machinery/atmospherics/pipe/simple/scrubbers/hidden{
	dir = 5
	},
/obj/machinery/atmospherics/pipe/simple/supply/hidden/layer1{
	dir = 5
	},
/turf/open/floor/plating,
/area/maintenance/starboard/aft)
"ap" = (
/obj/structure/disposalpipe/segment{
	dir = 4
	},
/obj/machinery/atmospherics/pipe/simple/scrubbers/hidden{
	dir = 4
	},
/obj/machinery/atmospherics/pipe/simple/supply/hidden/layer1{
	dir = 8
	},
/turf/open/floor/plating,
/area/maintenance/starboard/aft)
"aq" = (
/obj/structure/cable,
/obj/structure/disposalpipe/segment{
	dir = 5
	},
/obj/machinery/atmospherics/pipe/simple/scrubbers/hidden,
/obj/machinery/atmospherics/pipe/simple/supply/hidden/layer1{
	dir = 1
	},
/obj/machinery/light/small{
	brightness = 5;
	dir = 8
	},
/turf/open/floor/plating,
/area/maintenance/starboard/aft)
"ar" = (
/obj/structure/cable,
/obj/structure/disposalpipe/segment{
	dir = 4
	},
/turf/open/floor/plating,
/area/maintenance/starboard/aft)
"at" = (
/obj/structure/cable,
/obj/structure/disposalpipe/segment{
	dir = 9
	},
/turf/open/floor/plating,
/area/maintenance/starboard/aft)
"au" = (
/obj/structure/cable,
/obj/effect/turf_decal/stripes/line{
	dir = 4
	},
/turf/open/floor/plating,
/area/maintenance/starboard/aft)
"av" = (
/obj/structure/cable,
/obj/machinery/door/airlock/maintenance{
	req_access_txt = "12"
	},
/turf/open/floor/plating,
/area/maintenance/starboard/aft)
"aw" = (
/obj/structure/chair,
/obj/item/storage/fancy/cigarettes,
/obj/structure/disposalpipe/segment{
	dir = 4
	},
/obj/machinery/atmospherics/pipe/simple/scrubbers/hidden{
	dir = 4
	},
/obj/machinery/atmospherics/pipe/simple/supply/hidden/layer1{
	dir = 8
	},
/turf/open/floor/plating,
/area/maintenance/starboard/aft)
"ax" = (
/obj/structure/chair,
/obj/structure/disposalpipe/segment{
	dir = 4
	},
/obj/machinery/atmospherics/pipe/simple/scrubbers/hidden{
	dir = 4
	},
/obj/machinery/atmospherics/pipe/simple/supply/hidden/layer1{
	dir = 8
	},
/turf/open/floor/plating,
/area/maintenance/starboard/aft)
"ay" = (
/obj/structure/disposalpipe/segment{
	dir = 4
	},
/obj/machinery/atmospherics/pipe/simple/scrubbers/hidden{
	dir = 4
	},
/obj/structure/closet/crate,
/obj/effect/spawner/lootdrop/maintenance{
	lootcount = 2;
	name = "2maintenance loot spawner"
	},
/obj/machinery/atmospherics/pipe/simple/supply/hidden/layer1{
	dir = 8
	},
/turf/open/floor/plating,
/area/maintenance/starboard/aft)
"az" = (
/obj/effect/mapping_helpers/airlock/cyclelink_helper,
/obj/machinery/door/airlock/external{
	name = "External Access";
	req_access_txt = "13"
	},
/obj/structure/fans/tiny,
/turf/open/floor/plating,
/area/maintenance/aft)
"aA" = (
/obj/structure/disposalpipe/segment{
	dir = 4
	},
/obj/machinery/atmospherics/pipe/simple/scrubbers/hidden{
	dir = 4
	},
/obj/machinery/atmospherics/pipe/simple/supply/hidden/layer1{
	dir = 8
	},
/turf/closed/wall,
/area/maintenance/starboard/aft)
"aD" = (
/obj/effect/spawner/structure/window/reinforced,
/turf/open/floor/plating,
/area/maintenance/aft)
"aE" = (
/obj/effect/mapping_helpers/airlock/cyclelink_helper{
	dir = 1
	},
/obj/machinery/door/airlock/external{
	name = "External Access";
	req_access_txt = "13"
	},
/turf/open/floor/plating,
/area/maintenance/aft)
"aF" = (
/turf/closed/wall,
/area/maintenance/aft)
"aI" = (
/obj/machinery/chem_master{
	pixel_x = -3
	},
/turf/template_noop,
/area/template_noop)
"aJ" = (
/obj/machinery/chem_dispenser,
/turf/template_noop,
/area/template_noop)
"aO" = (
/obj/machinery/light/small{
	dir = 8
	},
/turf/open/floor/plating,
/area/maintenance/aft)
"hF" = (
/obj/structure/lattice/catwalk,
/turf/open/space/basic,
/area/space/nearstation)
"pJ" = (
/obj/structure/cable,
/obj/machinery/light/small{
	dir = 1
	},
/turf/open/floor/plating,
/area/maintenance/starboard/aft)
"vT" = (
/obj/structure/lattice,
/turf/open/space/basic,
/area/space/nearstation)

(1,1,1) = {"
ab
ab
aI
ab
ab
aF
aF
aD
hF
ab
"}
(2,1,1) = {"
ab
ab
aJ
ab
ab
az
aO
aE
hF
vT
"}
(3,1,1) = {"
ab
ab
ab
ab
ab
aF
aD
aD
hF
vT
"}
(4,1,1) = {"
ad
ad
ad
aq
ao
aa
ab
ab
hF
vT
"}
(5,1,1) = {"
ab
aa
aa
ar
ap
aa
ab
ab
hF
ab
"}
(6,1,1) = {"
ab
ab
aa
ar
ap
aj
ab
ab
ab
ab
"}
(7,1,1) = {"
ab
ab
aj
ar
ap
aj
ab
ab
ab
ab
"}
(8,1,1) = {"
ab
ab
aj
ar
ap
aj
ab
ab
ab
ab
"}
(9,1,1) = {"
ab
ab
aa
ar
ap
aa
ab
ab
ab
ab
"}
(10,1,1) = {"
ab
ab
aa
ai
ap
aa
ab
ab
ab
ab
"}
(11,1,1) = {"
ab
ac
aj
ar
aw
aj
ab
ab
ab
ab
"}
(12,1,1) = {"
ab
ah
al
at
ax
aj
ab
ab
ab
ab
"}
(13,1,1) = {"
ab
ac
aj
ak
ap
aj
ab
ab
ab
ab
"}
(14,1,1) = {"
ab
ab
aa
ak
ap
aa
ab
ab
ab
ab
"}
(15,1,1) = {"
ab
ab
aa
pJ
ap
aa
ab
ab
ab
ab
"}
(16,1,1) = {"
ab
ab
aj
ak
ap
aj
ab
ab
ab
ab
"}
(17,1,1) = {"
ab
ab
aj
ak
ap
aj
ab
ab
ab
ab
"}
(18,1,1) = {"
ab
ab
aj
au
ay
aj
ab
ab
ab
ab
"}
(19,1,1) = {"
ab
ab
aa
av
aA
aa
ab
ab
ab
ab
"}
