//MAP CONVERTED BY dmm2tgm.py THIS HEADER COMMENT PREVENTS RECONVERSION, DO NOT REMOVE
"a" = (
/turf/template_noop,
/area/template_noop)
"b" = (
/obj/structure/disposalpipe/segment{
	dir = 4
	},
/obj/machinery/atmospherics/pipe/simple/scrubbers/hidden{
	dir = 4
	},
/obj/machinery/atmospherics/pipe/simple/supply/hidden/layer1{
	dir = 8
	},
/obj/effect/spawner/structure/window/reinforced,
/turf/open/space/basic,
/area/maintenance/starboard/aft)
"c" = (
/obj/effect/spawner/structure/window/reinforced,
/turf/open/floor/plating,
/area/maintenance/starboard/aft)
"d" = (
/obj/structure/cable,
/obj/structure/disposalpipe/segment,
/obj/machinery/atmospherics/pipe/simple/scrubbers/hidden,
/obj/machinery/atmospherics/pipe/simple/supply/hidden/layer1{
	dir = 1
	},
/obj/machinery/door/airlock/external{
	name = "External Access";
	req_access_txt = "10; 13"
	},
/obj/effect/mapping_helpers/airlock/cyclelink_helper,
/turf/open/floor/plating,
/area/maintenance/starboard/aft)
"f" = (
/obj/structure/cable,
/obj/structure/disposalpipe/segment,
/obj/machinery/atmospherics/pipe/simple/scrubbers/hidden,
/obj/machinery/atmospherics/pipe/simple/supply/hidden/layer1{
	dir = 1
	},
/turf/open/floor/plating,
/area/maintenance/starboard/aft)
"g" = (
/turf/closed/wall,
/area/maintenance/starboard/aft)
"h" = (
/obj/structure/cable,
/obj/structure/disposalpipe/segment{
	dir = 4
	},
/turf/open/floor/plating/airless,
/area/space/nearstation)
"i" = (
/obj/structure/cable,
/obj/structure/disposalpipe/segment{
	dir = 4
	},
/obj/effect/landmark/event_spawn,
/turf/open/floor/plating/airless,
/area/space/nearstation)
"j" = (
/obj/structure/disposalpipe/segment{
	dir = 4
	},
/obj/machinery/atmospherics/pipe/simple/scrubbers/hidden{
	dir = 5
	},
/obj/machinery/atmospherics/pipe/simple/supply/hidden/layer1{
	dir = 5
	},
/turf/open/floor/plating/airless,
/area/space/nearstation)
"k" = (
/obj/structure/cable,
/obj/effect/turf_decal/stripes/line{
	dir = 4
	},
/turf/open/floor/plating,
/area/maintenance/starboard/aft)
"l" = (
/obj/structure/disposalpipe/segment{
	dir = 4
	},
/obj/machinery/atmospherics/pipe/simple/scrubbers/hidden{
	dir = 4
	},
/obj/machinery/atmospherics/pipe/simple/supply/hidden/layer1{
	dir = 8
	},
/turf/open/floor/plating/airless,
/area/space/nearstation)
"m" = (
/turf/closed/wall,
/area/maintenance/aft)
"o" = (
/obj/structure/lattice/catwalk,
/turf/open/space/basic,
/area/space/nearstation)
"r" = (
/obj/machinery/chem_dispenser,
/turf/template_noop,
/area/template_noop)
"t" = (
/obj/structure/cable,
/obj/machinery/door/airlock/external{
	name = "External Access";
	req_access_txt = "10; 13"
	},
/obj/effect/mapping_helpers/airlock/cyclelink_helper{
	dir = 8
	},
/obj/structure/fans/tiny,
/turf/open/floor/plating,
/area/maintenance/starboard/aft)
"u" = (
/obj/structure/lattice,
/turf/open/space,
/area/space/nearstation)
"v" = (
/obj/structure/disposalpipe/segment,
/turf/open/floor/plating/airless,
/area/space/nearstation)
"w" = (
/obj/structure/cable,
/turf/open/floor/plating/airless,
/area/space/nearstation)
"x" = (
/obj/structure/cable,
/obj/structure/disposalpipe/segment{
	dir = 5
	},
/obj/machinery/atmospherics/pipe/simple/scrubbers/hidden,
/obj/machinery/atmospherics/pipe/simple/supply/hidden/layer1{
	dir = 1
	},
/turf/open/floor/plating/airless,
/area/space/nearstation)
"y" = (
/obj/structure/cable,
/obj/structure/disposalpipe/segment{
	dir = 9
	},
/turf/open/floor/plating/airless,
/area/space/nearstation)
"E" = (
/obj/structure/lattice,
/turf/open/space/basic,
/area/space/nearstation)
"M" = (
/obj/structure/cable,
/obj/machinery/door/airlock/external{
	name = "External Access";
	req_access_txt = "10; 13"
	},
/obj/effect/mapping_helpers/airlock/cyclelink_helper{
	dir = 4
	},
/turf/open/floor/plating,
/area/maintenance/starboard/aft)
"P" = (
/obj/structure/disposalpipe/segment{
	dir = 4
	},
/obj/machinery/atmospherics/pipe/simple/scrubbers/hidden{
	dir = 4
	},
/obj/machinery/atmospherics/pipe/simple/supply/hidden/layer1{
	dir = 8
	},
/turf/closed/wall,
/area/maintenance/starboard/aft)
"V" = (
/obj/machinery/chem_master{
	pixel_x = -3
	},
/turf/template_noop,
/area/template_noop)
"X" = (
/obj/structure/cable,
/obj/structure/disposalpipe/segment,
/obj/machinery/atmospherics/pipe/simple/scrubbers/hidden,
/obj/machinery/atmospherics/pipe/simple/supply/hidden/layer1{
	dir = 1
	},
/obj/machinery/door/airlock/external{
	name = "External Access";
	req_access_txt = "10; 13"
	},
/obj/effect/mapping_helpers/airlock/cyclelink_helper{
	dir = 1
	},
/obj/structure/fans/tiny,
/turf/open/floor/plating,
/area/maintenance/starboard/aft)

(1,1,1) = {"
a
a
a
a
V
m
m
a
a
a
"}
(2,1,1) = {"
a
a
a
a
r
m
a
a
a
a
"}
(3,1,1) = {"
a
a
a
a
a
m
a
a
a
a
"}
(4,1,1) = {"
d
f
X
x
j
o
a
a
a
a
"}
(5,1,1) = {"
a
g
g
h
l
o
a
a
E
a
"}
(6,1,1) = {"
a
a
o
h
l
o
a
a
a
a
"}
(7,1,1) = {"
a
a
o
h
l
o
a
a
a
a
"}
(8,1,1) = {"
a
a
o
h
l
o
a
a
a
a
"}
(9,1,1) = {"
a
a
o
h
l
o
a
a
a
a
"}
(10,1,1) = {"
a
a
o
i
l
o
a
a
a
a
"}
(11,1,1) = {"
a
u
o
h
l
o
a
a
a
a
"}
(12,1,1) = {"
a
v
v
y
l
o
a
a
a
a
"}
(13,1,1) = {"
a
u
o
w
l
o
a
a
a
a
"}
(14,1,1) = {"
a
a
o
w
l
o
a
a
a
a
"}
(15,1,1) = {"
a
a
o
w
l
o
a
a
a
a
"}
(16,1,1) = {"
a
a
o
w
l
o
a
a
a
a
"}
(17,1,1) = {"
a
a
c
M
b
o
a
a
a
a
"}
(18,1,1) = {"
a
a
c
k
b
o
a
a
a
a
"}
(19,1,1) = {"
a
a
g
t
P
g
a
a
a
a
"}
